Fold,assay_id,AUC,Test_Set_Length,Num_Actives,Num_Inactives
0,1_1,0.47619047619047616,22,1,21
0,100_277,0.4375,9,1,8
0,100_278,0.35714285714285715,9,2,7
0,104_291,0.5897435897435898,16,3,13
0,105_369,0.4666666666666667,16,1,15
0,105_361,0.4666666666666667,16,1,15
0,105_378,0.41818181818181815,16,5,11
0,105_352,0.5999999999999999,16,6,10
0,104_289,0.5897435897435898,16,3,13
0,105_375,0.4285714285714286,16,2,14
0,104_300,0.2857142857142857,10,3,7
0,104_326,0.5238095238095237,10,3,7
0,104_323,0.4444444444444444,10,1,9
0,105_339,0.41818181818181815,16,5,11
0,105_341,0.6666666666666666,16,4,12
0,105_360,0.41818181818181815,16,5,11
0,105_362,0.4666666666666666,16,6,10
0,105_374,0.4666666666666666,16,6,10
0,105_382,0.4920634920634921,16,7,9
0,105_385,0.4375,9,1,8
0,105_391,1.0,9,1,8
0,106_392,0.46875,17,1,16
0,108_394,0.35714285714285715,9,2,7
0,109_395,0.6785714285714286,9,2,7
0,11_21,0.6785714285714286,9,2,7
0,11_22,0.35714285714285715,9,2,7
0,110_397,0.4444444444444444,40,4,36
0,110_398,0.5098039215686274,40,6,34
0,110_399,0.45945945945945943,40,3,37
0,110_400,0.4736842105263158,40,2,38
0,110_401,0.4285714285714286,40,5,35
0,111_402,0.46296296296296297,29,2,27
0,112_406,0.4375,9,1,8
0,113_407,0.325,9,4,5
0,114_408,0.4375,9,1,8
0,116_411,0.42,29,4,25
0,116_412,0.4642857142857143,30,2,28
0,116_415,0.44999999999999996,11,5,6
0,116_416,0.4,12,2,10
0,116_421,0.4285714285714286,16,2,14
0,116_424,0.611111111111111,21,3,18
0,116_425,0.46875,17,1,16
0,116_426,0.4642857142857143,30,2,28
0,116_427,0.4746376811594203,29,6,23
0,117_429,0.48660714285714285,23,7,16
0,117_430,0.425,23,3,20
0,118_432,0.4285714285714286,16,2,14
0,118_434,0.7083333333333334,7,3,4
0,12_23,0.5499999999999999,18,8,10
0,13_24,0.5499999999999999,18,8,10
0,14_25,0.3076923076923077,18,5,13
0,143_495,0.39285714285714285,17,3,14
0,145_497,0.3888888888888889,11,2,9
0,15_26,0.47058823529411764,18,1,17
0,153_510,0.45,11,1,10
0,154_511,0.4444444444444444,10,1,9
0,16_27,0.5846153846153845,18,5,13
0,167_539,0.45,11,1,10
0,167_538,0.45,11,1,10
0,168_541,0.4444444444444444,20,2,18
0,168_542,0.4642857142857143,15,1,14
0,168_543,0.4230769230769231,15,2,13
0,169_544,0.45,22,2,20
0,169_545,0.47619047619047616,22,1,21
0,169_548,0.45,22,2,20
0,169_549,0.42708333333333337,22,6,16
0,170_550,0.43333333333333335,17,2,15
0,170_551,0.46875,17,1,16
0,174_555,0.475,21,1,20
0,175_559,0.4375,9,1,8
0,175_561,0.4375,9,1,8
0,177_585,0.49683544303797467,318,2,316
0,178_684,0.501733375354554,186,19,167
0,179_659,0.4949664429530201,301,3,298
0,18_29,0.35714285714285715,18,4,14
0,180_686,0.4982847341337907,117,11,106
0,181_599,0.4583333333333333,13,1,12
0,181_600,0.4583333333333333,13,1,12
0,183_604,0.5173913043478262,148,10,138
0,184_606,0.5283145464304885,185,23,162
0,185_665,0.5545746388443018,185,7,178
0,185_666,0.542725988700565,185,8,177
0,186_668,0.48404255319148937,194,6,188
0,186_669,0.48947368421052634,194,4,190
0,19_30,0.5,16,4,12
0,190_628,0.4806949806949807,269,10,259
0,190_629,0.48863636363636365,270,6,264
0,190_674,0.48823529411764705,261,6,255
0,191_630,0.4887640449438202,546,12,534
0,191_631,0.4906716417910448,546,10,536
0,191_675,0.4975247524752475,203,1,202
0,192_635,0.6,18,3,15
0,193_723,0.5757575757575758,175,10,165
0,194_639,0.48467966573816157,370,11,359
0,194_678,0.49473684210526314,288,3,285
0,195_642,0.5013098356751607,349,26,323
0,196_644,0.4992248062015504,646,1,645
0,197_645,0.5335477941176471,145,17,128
0,197_646,0.5853758169934641,145,9,136
0,197_647,0.5416666666666667,22,4,18
0,197_648,0.47619047619047616,22,1,21
0,197_649,0.5086786114221725,351,47,304
0,197_650,0.49629909365558916,351,20,331
0,197_651,0.49130434782608695,351,6,345
0,198_682,0.5360628723539105,366,23,343
0,199_657,0.4777158774373259,375,16,359
0,201_660,0.4925373134328358,68,1,67
0,202_661,0.49264705882352944,483,7,476
0,203_662,0.49592391304347827,371,3,368
0,204_663,0.49864864864864866,371,1,370
0,205_664,0.4689655172413793,495,60,435
0,206_670,0.48988439306358383,353,7,346
0,206_671,0.48240469208211145,353,12,341
0,207_672,0.4797619047619048,437,17,420
0,208_673,0.4904109589041096,372,7,365
0,209_676,0.49898785425101216,495,1,494
0,210_677,0.4916083916083916,727,12,715
0,212_680,0.49733333333333335,377,2,375
0,213_681,0.500795334040297,269,23,246
0,214_683,0.49441340782122906,362,4,358
0,215_685,0.49149659863945583,416,24,392
0,216_687,0.49333333333333335,380,5,375
0,217_688,0.5395064362420879,370,43,327
0,217_689,0.47377622377622375,301,15,286
0,219_691,0.4946091644204852,375,4,371
0,220_692,0.4964512574539797,2260,56,2204
0,221_693,0.5071142093200917,3069,77,2992
0,223_695,0.4973821989528796,384,2,382
0,224_696,0.48183760683760685,485,17,468
0,225_697,0.49573863636363635,355,3,352
0,227_699,0.49356223175965663,472,6,466
0,228_700,0.5433624031007752,145,16,129
0,229_701,0.5555880320986343,669,62,607
0,23_34,0.4583333333333333,13,1,12
0,230_702,0.5373595505617978,366,10,356
0,231_703,0.49610323312535454,1813,50,1763
0,232_704,0.46851253799392095,361,32,329
0,232_705,0.5061559507523941,361,17,344
0,233_706,0.4923531456378172,2921,44,2877
0,234_707,0.4993985537952622,3084,98,2986
0,235_708,0.518451491069321,2040,71,1969
0,236_709,0.5234375,488,40,448
0,237_710,0.4905857740585774,487,9,478
0,237_711,0.49732620320855614,188,1,187
0,238_712,0.49960082970397246,2753,106,2647
0,239_713,0.4923596304193319,2857,43,2814
0,240_714,0.5038090568976787,2771,108,2663
0,241_715,0.5047369297369297,2902,130,2772
0,242_716,0.5225730977466135,2910,49,2861
0,243_717,0.49601938386985117,2912,23,2889
0,244_718,0.4967213114754098,2763,18,2745
0,245_719,0.5026406429391503,361,26,335
0,246_720,0.49629355077835435,2718,20,2698
0,247_721,0.49535423925667826,2607,24,2583
0,248_722,0.49906695156695163,2654,54,2600
0,249_724,0.4895390600967892,2740,87,2653
0,250_726,0.4967159277504105,613,4,609
0,251_727,0.4979385307346327,2679,11,2668
0,253_729,0.5106113398796325,309,22,287
0,254_730,0.49056603773584906,378,7,371
0,257_735,0.5002616431187861,382,39,343
0,258_736,0.4959677419354839,375,3,372
0,259_737,0.4982841455044612,1462,5,1457
0,260_738,0.4949003450833683,2557,101,2456
0,261_739,0.5118373289720372,999,53,946
0,262_740,0.4897959183673469,450,9,441
0,263_741,0.544047619047619,383,35,348
0,264_742,0.49897048730267674,2920,6,2914
0,265_743,0.49806675224646985,2539,164,2375
0,266_744,0.4893687707641196,1537,32,1505
0,267_745,0.5099365079365079,1795,45,1750
0,268_746,0.4948046717680225,2548,65,2483
0,269_747,0.5150951002425119,3025,108,2917
0,27_38,0.5227272727272727,21,10,11
0,27_39,0.611111111111111,21,3,18
0,27_40,0.4666666666666667,16,1,15
0,270_748,0.49618055555555557,2902,22,2880
0,271_749,0.4812689969604863,369,40,329
0,272_750,0.48758278145695366,619,15,604
0,273_751,0.4862385321100917,336,9,327
0,274_752,0.4968480424684804,3033,19,3014
0,275_753,0.5215201465201464,285,12,273
0,275_754,0.49629878869448185,2994,22,2972
0,276_755,0.5144396615266681,2635,26,2609
0,277_756,0.4991178546224418,2839,5,2834
0,278_757,0.5149217290048738,2649,83,2566
0,279_758,0.4977856510186005,2268,10,2258
0,280_759,0.5381789497408158,2644,34,2610
0,281_760,0.49257425742574257,410,6,404
0,283_762,0.5097117794486216,313,28,285
0,29_43,0.46153846153846156,14,1,13
0,3_3,0.45,11,1,10
0,37_69,1.0,9,1,8
0,37_70,0.4375,9,1,8
0,37_74,0.6785714285714286,9,2,7
0,37_77,0.4375,9,1,8
0,40_95,0.4375,9,1,8
0,40_96,0.4375,9,1,8
0,46_120,0.5,9,3,6
0,5_5,0.4166666666666667,21,3,18
0,53_178,0.4375,9,1,8
0,7_10,0.4444444444444444,10,1,9
0,7_11,0.375,10,2,8
0,71_212,0.6785714285714286,9,2,7
0,71_213,0.75,9,3,6
0,76_230,0.46153846153846156,14,1,13
0,8_12,0.5238095238095237,10,3,7
0,8_13,0.5238095238095237,10,3,7
0,80_239,0.35,13,3,10
0,82_242,0.39473684210526316,23,4,19
0,82_243,1.0,8,1,7
0,85_247,0.625,12,4,8
0,86_249,1.0,9,1,8
0,88_254,0.4285714285714286,16,2,14
0,9_17,0.4285714285714286,8,1,7
0,91_257,0.2857142857142857,10,3,7
0,92_258,0.5238095238095237,10,3,7
0,93_259,0.5797101449275363,29,6,23
1,1_1,0.45,11,1,10
1,10_19,0.4285714285714286,8,1,7
1,100_277,1.0,6,1,5
1,100_278,0.6666666666666667,6,3,3
1,104_291,0.6500000000000001,7,2,5
1,105_355,0.4166666666666667,7,1,6
1,105_369,1.0,7,1,6
1,105_378,0.3,7,2,5
1,105_352,0.4166666666666667,7,1,6
1,104_289,0.4166666666666667,7,1,6
1,105_375,0.4166666666666667,7,1,6
1,104_299,0.25,3,1,2
1,104_300,1.0,4,1,3
1,104_326,1.0,4,1,3
1,104_323,0.25,3,2,1
1,105_339,0.4166666666666667,7,1,6
1,105_341,0.7083333333333334,7,3,4
1,105_360,0.4166666666666667,7,1,6
1,105_362,1.0,7,1,6
1,105_374,0.6500000000000001,7,2,5
1,105_382,1.0,7,2,5
1,106_392,1.0,6,1,5
1,108_394,0.375,5,1,4
1,109_395,0.375,5,1,4
1,11_21,0.25,3,1,2
1,110_397,0.4666666666666667,32,2,30
1,110_398,0.5285714285714286,33,5,28
1,110_399,0.4852941176470588,35,1,34
1,110_401,0.4838709677419355,32,1,31
1,111_402,0.3666666666666667,19,4,15
1,113_407,0.25,3,1,2
1,116_411,0.7249999999999999,22,2,20
1,116_412,0.5416666666666667,22,4,18
1,116_416,1.0,4,1,3
1,116_420,0.4375,9,1,8
1,116_425,0.4375,9,1,8
1,116_426,0.42105263157894735,22,3,19
1,116_427,0.45,22,2,20
1,117_429,0.6666666666666666,8,2,6
1,118_432,0.6078431372549019,20,3,17
1,118_434,0.25,3,2,1
1,12_23,0.6500000000000001,7,2,5
1,13_24,0.7083333333333334,7,3,4
1,134_476,0.0,2,1,1
1,14_25,0.4166666666666667,7,1,6
1,143_495,0.6785714285714286,9,2,7
1,168_541,0.4583333333333333,13,1,12
1,168_542,0.4166666666666667,7,1,6
1,168_543,0.4166666666666667,7,1,6
1,169_544,0.6666666666666666,8,2,6
1,169_545,0.4285714285714286,8,1,7
1,169_548,0.4285714285714286,8,1,7
1,169_549,0.4285714285714286,8,1,7
1,17_28,1.0,7,1,6
1,170_550,0.375,5,1,4
1,177_585,0.4920212765957447,382,6,376
1,178_684,0.4589041095890411,158,12,146
1,179_659,0.49866310160427807,375,1,374
1,18_29,0.4166666666666667,7,1,6
1,180_686,0.5170940170940171,113,9,104
1,181_599,0.4,6,1,5
1,183_604,0.48770491803278687,125,3,122
1,184_606,0.5809018567639258,158,13,145
1,185_665,0.48598130841121495,220,6,214
1,185_666,0.5365982095839916,220,9,211
1,185_667,0.497716894977169,220,1,219
1,186_668,0.4798206278026906,232,9,223
1,186_669,0.49783549783549785,232,1,231
1,187_619,0.47619047619047616,22,1,21
1,190_628,0.49174917491749176,308,5,303
1,190_629,0.49506578947368424,307,3,304
1,190_674,0.4865771812080537,306,8,298
1,191_630,0.5274926170721418,560,13,547
1,191_631,0.48717948717948717,560,14,546
1,191_675,0.49166666666666664,244,4,240
1,193_723,0.5375302663438256,191,14,177
1,194_639,0.4855072463768116,355,10,345
1,194_678,0.4957983193277311,360,3,357
1,195_642,0.5471874999999999,345,25,320
1,196_644,0.4968701095461659,643,4,639
1,197_645,0.518796992481203,152,19,133
1,197_646,0.48299319727891155,152,5,147
1,197_647,0.4,12,2,10
1,197_649,0.5020931449502878,346,52,294
1,197_650,0.4660493827160494,346,22,324
1,197_651,0.4956268221574344,346,3,343
1,198_682,0.507183908045977,343,24,319
1,199_657,0.5308346624136098,353,11,342
1,202_661,0.4891067538126362,469,10,459
1,203_662,0.49426934097421205,353,4,349
1,205_664,0.504202174551866,456,41,415
1,206_670,0.48520710059171596,348,10,338
1,206_671,0.48520710059171596,348,10,338
1,207_672,0.47853535353535354,413,17,396
1,208_673,0.48863636363636365,360,8,352
1,209_676,0.49603174603174605,508,4,504
1,210_677,0.5054909768158756,700,23,677
1,212_680,0.49859943977591037,358,1,357
1,213_681,0.5382182393252504,292,21,271
1,214_683,0.48830409356725146,350,8,342
1,215_685,0.4918478260869565,391,23,368
1,216_687,0.49022346368715086,365,7,358
1,217_688,0.478395061728395,351,27,324
1,217_689,0.5317182817182816,375,11,364
1,219_691,0.5761494252873564,354,6,348
1,220_692,0.48725534820209376,2253,56,2197
1,221_693,0.5038683157120035,3071,113,2958
1,223_695,0.4888268156424581,366,8,358
1,224_696,0.5580596399615226,402,19,383
1,225_697,0.4956395348837209,347,3,344
1,227_699,0.4987244897959184,393,1,392
1,228_700,0.5445736434108527,141,12,129
1,229_701,0.5479589759250777,725,59,666
1,23_34,1.0,5,1,4
1,230_702,0.4898255813953488,351,7,344
1,231_703,0.4977314516321608,1829,47,1782
1,232_704,0.5380222104706505,336,31,305
1,232_705,0.515527950310559,336,14,322
1,233_706,0.49462179042331716,2913,31,2882
1,234_707,0.5095334617073748,3089,99,2990
1,235_708,0.5235474006116208,2052,90,1962
1,236_709,0.4789501039501039,401,37,364
1,237_710,0.48982188295165396,401,8,393
1,237_711,0.49242424242424243,134,2,132
1,238_712,0.49711887459056625,2659,97,2562
1,239_713,0.49498567335243554,2820,28,2792
1,24_35,0.5833333333333333,5,3,2
1,240_714,0.4866986148856572,2651,114,2537
1,241_715,0.5130213041542426,2842,137,2705
1,242_716,0.5063279857397505,2865,60,2805
1,243_717,0.4934675141242938,2869,37,2832
1,244_718,0.4990569596378725,2656,5,2651
1,245_719,0.5433911882510013,342,21,321
1,246_720,0.49713631156930127,2634,15,2619
1,247_721,0.49200958849380744,2543,40,2503
1,248_722,0.4904119887730553,2574,80,2494
1,249_724,0.49344093139883644,2634,107,2527
1,25_36,1.0,5,1,4
1,250_725,0.4973045822102426,746,4,742
1,250_726,0.49594594594594593,746,6,740
1,251_727,0.49793466015771687,2674,11,2663
1,253_729,0.5373949579831933,367,17,350
1,254_730,0.49444444444444446,364,4,360
1,257_735,0.4754700854700855,361,36,325
1,258_736,0.4957627118644068,357,3,354
1,259_737,0.4982841455044612,1462,5,1457
1,260_738,0.5112319385912101,2504,88,2416
1,261_739,0.4794504853559972,943,54,889
1,262_740,0.5313302516692346,365,11,354
1,263_741,0.49746376811594206,365,20,345
1,264_742,0.5824595129907958,2867,6,2861
1,265_743,0.5081596937380366,2588,150,2438
1,266_744,0.4878808864265928,1479,35,1444
1,267_745,0.510562315501476,1658,43,1615
1,268_746,0.4990826481211097,2454,88,2366
1,269_747,0.5059077432856646,3022,94,2928
1,27_38,0.4722222222222222,19,10,9
1,27_39,0.3910256410256411,19,6,13
1,270_748,0.4951066060817896,2889,28,2861
1,271_749,0.510343618513324,294,46,248
1,272_750,0.4868238557558946,740,19,721
1,273_751,0.48509933774834435,311,9,302
1,274_752,0.49633577614923385,3024,22,3002
1,275_753,0.4859154929577465,219,6,213
1,275_754,0.4961214165261383,2988,23,2965
1,276_755,0.49603489294210945,2542,20,2522
1,277_756,0.4994671403197158,2818,3,2815
1,278_757,0.49671052631578944,2550,80,2470
1,279_758,0.4969551979121357,2313,14,2299
1,280_759,0.4948392219134577,2545,26,2519
1,281_760,0.4956140350877193,345,3,342
1,283_762,0.49462564862861375,303,19,284
1,37_74,0.25,3,1,2
1,46_120,0.25,3,2,1
1,5_5,0.4375,9,1,8
1,6_7,0.4,6,1,5
1,7_11,1.0,3,1,2
1,70_211,0.4166666666666667,7,1,6
1,71_212,0.25,3,1,2
1,71_213,0.25,3,2,1
1,8_12,1.0,3,1,2
1,8_13,0.25,3,1,2
1,82_242,0.33333333333333337,8,2,6
1,83_245,1.0,3,1,2
1,85_247,0.5,4,2,2
1,88_252,0.45,11,1,10
1,88_254,0.4166666666666667,7,1,6
1,89_255,0.4,6,1,5
1,90_256,0.46,27,2,25
1,91_257,0.25,3,2,1
1,92_258,0.25,3,2,1
1,93_259,0.6117647058823529,22,5,17
2,10_20,0.46875,17,1,16
2,100_277,0.4444444444444444,10,1,9
2,100_278,0.33333333333333337,12,3,9
2,105_355,0.46153846153846156,14,1,13
2,105_361,0.46153846153846156,14,1,13
2,105_352,0.46153846153846156,14,1,13
2,105_375,0.46153846153846156,14,1,13
2,104_325,1.0,9,1,8
2,104_299,0.4375,9,1,8
2,104_323,0.6785714285714286,9,2,7
2,105_339,0.4166666666666667,14,2,12
2,105_341,1.0,14,1,13
2,105_362,0.46153846153846156,14,1,13
2,105_382,0.46153846153846156,14,1,13
2,105_385,0.4444444444444444,10,1,9
2,105_391,0.4444444444444444,10,1,9
2,108_394,0.45,11,1,10
2,109_395,0.3125,11,3,8
2,110_397,0.47435897435897434,41,2,39
2,110_398,0.4605263157894737,41,3,38
2,110_399,0.4878048780487805,42,1,41
2,110_400,0.4875,41,1,40
2,110_401,0.4305555555555556,41,5,36
2,111_402,0.4791666666666667,25,1,24
2,113_407,0.45,11,1,10
2,116_411,0.467741935483871,33,2,31
2,116_412,0.734375,34,2,32
2,116_413,0.4642857142857143,15,1,14
2,116_414,0.4642857142857143,15,1,14
2,116_415,0.45454545454545453,12,1,11
2,116_416,0.40909090909090906,13,2,11
2,116_420,0.475,21,1,20
2,116_421,0.475,21,1,20
2,116_424,0.4722222222222222,19,1,18
2,116_426,0.43333333333333335,34,4,30
2,116_427,0.43103448275862066,33,4,29
2,117_429,0.45,22,2,20
2,117_430,0.47619047619047616,22,1,21
2,118_434,0.35714285714285715,9,2,7
2,12_23,0.4285714285714286,16,2,14
2,13_24,0.4285714285714286,16,2,14
2,134_477,0.4583333333333333,13,1,12
2,14_25,0.7142857142857143,16,2,14
2,143_495,0.6041666666666666,19,3,16
2,154_511,0.6944444444444444,11,2,9
2,16_27,0.4666666666666667,16,1,15
2,167_539,0.45454545454545453,12,1,11
2,167_538,0.45454545454545453,12,1,11
2,168_542,0.6041666666666666,19,3,16
2,168_543,0.40625,19,3,16
2,169_544,0.4375,18,2,16
2,169_545,1.0,18,1,17
2,169_549,0.6785714285714286,18,4,14
2,170_550,0.4642857142857143,15,1,14
2,170_551,0.4642857142857143,15,1,14
2,174_555,0.4791666666666667,25,1,24
2,177_585,0.4981481481481482,271,1,270
2,178_684,0.4697802197802198,193,11,182
2,179_659,0.4959839357429719,251,2,249
2,18_29,0.4285714285714286,16,2,14
2,180_686,0.4753521126760563,149,7,142
2,183_604,0.47586206896551725,152,7,145
2,184_606,0.4839572192513369,193,17,176
2,185_665,0.49583333333333335,121,1,120
2,185_666,0.4872881355932203,121,3,118
2,186_668,0.5874213836477987,164,5,159
2,187_618,0.48091603053435117,136,5,131
2,187_619,0.4736842105263158,40,2,38
2,19_30,0.4583333333333333,13,1,12
2,190_628,0.48195876288659795,201,7,194
2,190_629,0.4872448979591837,201,5,196
2,190_674,0.4921052631578947,193,3,190
2,191_630,0.5783828382838284,511,6,505
2,191_631,0.4930555555555556,511,7,504
2,191_675,0.49333333333333335,152,2,150
2,192_635,0.4444444444444444,20,2,18
2,193_723,0.465625,171,11,160
2,194_639,0.48289473684210527,393,13,380
2,194_678,0.4876237623762376,207,5,202
2,195_642,0.4862921348314607,381,25,356
2,196_644,0.498330550918197,601,2,599
2,197_645,0.513888888888889,84,12,72
2,197_646,0.46835443037974683,84,5,79
2,197_647,0.4807692307692308,27,1,26
2,197_648,0.4807692307692308,27,1,26
2,197_649,0.5227272727272727,231,33,198
2,197_650,0.4602803738317757,231,17,214
2,197_651,0.4889380530973451,231,5,226
2,198_682,0.4563380281690141,386,31,355
2,199_657,0.48586118251928023,400,11,389
2,200_658,0.375,10,4,6
2,201_660,0.4765625,67,3,64
2,202_661,0.49437148217636023,539,6,533
2,203_662,0.4948586118251928,393,4,389
2,204_663,0.4987146529562982,390,1,389
2,205_664,0.4627594627594627,500,45,455
2,206_670,0.4921052631578947,386,6,380
2,206_671,0.49076517150395776,386,7,379
2,207_672,0.49,306,6,300
2,208_673,0.4961734693877551,395,3,392
2,209_676,0.4966887417218543,456,3,453
2,210_677,0.4790969899665552,623,25,598
2,212_680,0.49625935162094764,404,3,401
2,213_681,0.4810896588204179,218,19,199
2,214_683,0.49222797927461137,392,6,386
2,215_685,0.515688445921004,328,27,301
2,216_687,0.49264705882352944,414,6,408
2,217_688,0.5265669515669515,391,40,351
2,217_689,0.4993351063829788,251,16,235
2,219_691,0.48743718592964824,408,10,398
2,220_692,0.4984597268016957,2173,50,2123
2,221_693,0.4942547243654255,3056,75,2981
2,223_695,0.49019607843137253,416,8,408
2,224_696,0.4990252411245639,465,22,443
2,225_697,0.49619289340101524,397,3,394
2,227_699,0.4933184855233853,455,6,449
2,228_700,0.5020983213429256,151,12,139
2,229_701,0.5041378374711708,645,78,567
2,230_702,0.48663101604278075,384,10,374
2,231_703,0.5183544195001203,1779,68,1711
2,232_704,0.4910648826979472,383,31,352
2,232_705,0.4838274932614555,383,12,371
2,233_706,0.49545613421880463,2887,26,2861
2,234_707,0.49651027408036746,3077,107,2970
2,235_708,0.4965056235749459,2041,108,1933
2,236_709,0.46952411994784876,465,52,413
2,237_710,0.48337028824833705,466,15,451
2,237_711,0.49691358024691357,163,1,162
2,238_712,0.4976428571428571,2705,80,2625
2,239_713,0.4949389179755672,2894,29,2865
2,24_35,0.40909090909090906,13,2,11
2,240_714,0.502074991658325,2703,111,2592
2,241_715,0.5048792584709577,2927,108,2819
2,242_716,0.5003173667626324,2939,93,2846
2,243_717,0.5057989690721649,2950,40,2910
2,244_718,0.4973997028231798,2706,14,2692
2,245_719,0.4777777777777778,376,36,340
2,246_720,0.4963878326996198,2649,19,2630
2,247_721,0.49216607912260085,2593,40,2553
2,248_722,0.491095801377876,2610,98,2512
2,249_724,0.5045808966861599,2691,126,2565
2,25_36,0.40909090909090906,13,2,11
2,250_725,0.4982300884955752,567,2,565
2,250_726,0.49193548387096775,567,9,558
2,251_727,0.4971220260936301,2621,15,2606
2,253_729,0.49429657794676807,266,3,263
2,254_730,0.49203187250996017,255,4,251
2,257_735,0.4909586326480059,411,44,367
2,258_736,0.594949494949495,401,5,396
2,259_737,0.4965588437715072,1463,10,1453
2,260_738,0.49512770273784956,2452,98,2354
2,261_739,0.5375422213391614,789,70,719
2,262_740,0.49170616113744076,429,7,422
2,263_741,0.506084466714388,414,33,381
2,264_742,0.4983004758667573,2952,10,2942
2,265_743,0.5134887785136131,2596,180,2416
2,266_744,0.5052847731821214,1531,32,1499
2,267_745,0.4908368967623702,1667,30,1637
2,268_746,0.4822934232715008,2456,84,2372
2,269_747,0.4951562254671063,3005,110,2895
2,27_38,0.5,20,10,10
2,27_39,0.375,20,8,12
2,270_748,0.4963235294117647,2877,21,2856
2,271_749,0.4530522857924993,333,52,281
2,272_750,0.48973880597014924,547,11,536
2,273_751,0.5217948717948717,373,13,360
2,274_752,0.4965034965034965,3024,21,3003
2,275_753,0.4885057471264368,267,6,261
2,275_754,0.4968067226890756,2994,19,2975
2,276_755,0.4932216905901116,2542,34,2508
2,277_756,0.49892357373519913,2793,6,2787
2,278_757,0.5069051944556587,2549,72,2477
2,279_758,0.4970136518771331,2358,14,2344
2,280_759,0.5305610561056106,2540,15,2525
2,281_760,0.49355670103092786,393,5,388
2,283_762,0.4802649006622517,327,25,302
2,3_3,0.4583333333333333,13,1,12
2,37_70,0.375,10,2,8
2,40_95,0.4444444444444444,10,1,9
2,40_96,1.0,10,1,9
2,44_106,0.45,11,1,10
2,46_120,0.45,11,1,10
2,53_178,0.45,11,1,10
2,54_179,0.4444444444444444,10,1,9
2,54_182,0.6666666666666666,8,2,6
2,70_211,0.47058823529411764,18,1,17
2,71_212,0.45,11,1,10
2,71_213,0.45,11,1,10
2,80_239,0.45454545454545453,12,1,11
2,82_242,0.45,22,2,20
2,82_243,0.4285714285714286,8,1,7
2,83_244,0.4772727272727273,23,1,22
2,85_247,0.2777777777777778,13,4,9
2,85_248,0.7083333333333334,14,2,12
2,86_249,0.3888888888888889,11,2,9
2,86_250,0.6944444444444444,11,2,9
2,88_254,0.4,18,3,15
2,89_255,0.4666666666666667,16,1,15
2,9_18,0.33333333333333337,4,1,3
2,90_256,0.4864864864864865,38,1,37
2,92_258,0.6875,10,2,8
2,93_259,0.6085858585858586,31,9,22
3,100_277,0.41666666666666663,7,3,4
3,100_278,0.41666666666666663,7,4,3
3,104_291,0.6500000000000001,7,2,5
3,105_355,1.0,7,1,6
3,105_369,0.4166666666666667,7,1,6
3,105_378,0.6500000000000001,7,2,5
3,105_352,0.6500000000000001,7,2,5
3,104_289,0.6500000000000001,7,2,5
3,105_375,0.4166666666666667,7,1,6
3,104_325,0.33333333333333337,4,1,3
3,104_297,0.33333333333333337,4,1,3
3,104_299,0.5,4,2,2
3,104_300,0.25,3,1,2
3,104_323,1.0,4,2,2
3,105_339,0.3,7,2,5
3,105_341,0.6500000000000001,7,2,5
3,105_360,0.6500000000000001,7,2,5
3,105_362,0.6500000000000001,7,2,5
3,105_374,0.6500000000000001,7,2,5
3,105_382,0.3,7,2,5
3,108_394,0.4,6,1,5
3,109_395,0.4,6,1,5
3,11_22,0.33333333333333337,4,1,3
3,110_399,0.4565217391304348,25,2,23
3,110_401,0.425,23,3,20
3,111_402,0.4666666666666666,16,6,10
3,112_406,0.25,3,1,2
3,114_408,0.25,3,1,2
3,115_409,0.4166666666666667,7,1,6
3,116_411,0.4722222222222222,19,1,18
3,116_412,0.4375,18,2,16
3,116_426,1.0,18,1,17
3,116_427,0.40625,19,3,16
3,117_429,0.4285714285714286,8,1,7
3,117_430,0.4166666666666667,7,1,6
3,118_432,0.6,18,3,15
3,118_434,0.3333333333333333,4,3,1
3,12_23,0.7083333333333334,7,3,4
3,13_24,0.41666666666666663,7,3,4
3,133_474,0.375,5,1,4
3,134_477,0.375,5,1,4
3,14_25,0.41666666666666663,7,3,4
3,143_495,0.4444444444444444,10,1,9
3,15_26,0.7083333333333334,7,3,4
3,16_27,0.7083333333333334,7,4,3
3,160_519,0.48214285714285715,29,1,28
3,169_544,1.0,10,1,9
3,169_545,0.4444444444444444,10,1,9
3,169_549,0.39999999999999997,10,5,5
3,174_555,0.4375,9,1,8
3,177_585,0.49074074074074076,440,8,432
3,178_591,0.4444444444444444,10,1,9
3,178_684,0.5381578947368421,243,15,228
3,179_659,0.4976798143851508,433,2,431
3,180_686,0.44036697247706424,122,13,109
3,181_599,0.375,5,1,4
3,183_604,0.4863398203592814,183,16,167
3,184_606,0.5178571428571428,243,12,231
3,185_665,0.4785714285714286,292,12,280
3,185_666,0.5003208556149733,292,17,275
3,186_668,0.4898785425101215,252,5,247
3,187_618,0.4968454258675079,319,2,317
3,187_619,0.4772727272727273,23,1,22
3,19_30,0.5833333333333333,5,3,2
3,190_628,0.489159891598916,377,8,369
3,190_629,0.4905149051490515,376,7,369
3,190_674,0.4863013698630137,375,10,365
3,191_630,0.49529042386185246,643,6,637
3,191_631,0.4984399375975039,643,2,641
3,191_675,0.49666666666666665,302,2,300
3,192_635,0.4444444444444444,10,1,9
3,193_723,0.47478991596638653,250,12,238
3,194_639,0.47844827586206895,363,15,348
3,194_678,0.49722222222222223,362,2,360
3,195_642,0.5081300813008129,352,24,328
3,196_644,0.4978902953586498,714,3,711
3,197_645,0.5231581214993536,233,22,211
3,197_646,0.5581542351453855,233,7,226
3,197_647,0.4666666666666667,16,1,15
3,197_649,0.47741694662187384,560,47,513
3,197_650,0.478584729981378,560,23,537
3,197_651,0.49640287769784175,560,4,556
3,198_682,0.5108695652173914,345,23,322
3,199_657,0.6013618074899412,368,9,359
3,201_660,0.4824561403508772,59,2,57
3,202_661,0.4917184265010352,491,8,483
3,204_663,0.49145299145299143,357,6,351
3,205_664,0.5305580558055805,549,44,505
3,206_670,0.4943181818181818,356,4,352
3,206_671,0.49142857142857144,356,6,350
3,207_672,0.48045254007775295,626,39,587
3,208_673,0.4930747922437673,366,5,361
3,209_676,0.4991467576791809,587,1,586
3,210_677,0.4868565169769989,937,24,913
3,212_680,0.4973190348525469,375,2,373
3,213_681,0.5181199411331862,338,36,302
3,214_683,0.49299719887955185,362,5,357
3,215_685,0.5414221373003958,448,17,431
3,216_687,0.4932795698924731,377,5,372
3,217_688,0.49598100109609056,356,34,322
3,217_689,0.4857482185273159,433,12,421
3,219_691,0.49166666666666664,366,6,360
3,220_692,0.48609112709832136,2143,58,2085
3,221_693,0.4948772498872494,3080,73,3007
3,223_695,0.4893048128342246,382,8,374
3,224_696,0.5104241552839683,454,26,428
3,225_697,0.49584487534626037,364,3,361
3,227_699,0.4943946188340807,451,5,446
3,228_700,0.4794871794871795,203,8,195
3,229_701,0.4871723626933408,791,59,732
3,23_34,0.4166666666666667,7,1,6
3,230_702,0.48863636363636365,360,8,352
3,231_703,0.5020315178844031,1631,54,1577
3,232_704,0.4736276721452358,350,29,321
3,232_705,0.5053877406818583,350,17,333
3,233_706,0.4947294448348559,2876,30,2846
3,234_707,0.510600881266178,3096,119,2977
3,235_708,0.5284393387503502,2244,86,2158
3,236_709,0.5250814515223009,457,43,414
3,237_710,0.49223946784922396,458,7,451
3,237_711,0.4971751412429379,178,1,177
3,238_712,0.49534676185619586,2639,148,2491
3,239_713,0.49178532311062434,2784,45,2739
3,24_35,0.6500000000000001,7,2,5
3,240_714,0.5125233734862408,2641,98,2543
3,241_715,0.5081678287785159,2850,99,2751
3,242_716,0.5065952838819291,2857,38,2819
3,243_717,0.5088775531406486,2865,34,2831
3,244_718,0.5187226960682338,2644,22,2622
3,245_719,0.5295333405852279,346,29,317
3,246_720,0.5143858079904592,2606,26,2580
3,247_721,0.5087947412142882,2550,33,2517
3,248_722,0.5152756993208242,2552,70,2482
3,249_724,0.5065757030521125,2621,120,2501
3,25_36,0.3,7,2,5
3,250_725,0.5798465829846583,723,6,717
3,250_726,0.4886845827439887,723,16,707
3,251_727,0.4957578094870806,2615,22,2593
3,253_729,0.4744245524296675,411,20,391
3,254_730,0.49914529914529915,586,1,585
3,257_735,0.5075631468480858,378,41,337
3,258_736,0.49728260869565216,370,2,368
3,259_737,0.49688715953307394,1293,8,1285
3,260_738,0.49829293497455757,2416,134,2282
3,261_739,0.49034850533273244,993,42,951
3,262_740,0.49142156862745096,415,7,408
3,263_741,0.4887104283054004,382,24,358
3,264_742,0.49912739965095987,2870,5,2865
3,265_743,0.4913259262591277,2714,129,2585
3,266_744,0.4955359529537557,1348,43,1305
3,267_745,0.5143898111107611,1850,53,1797
3,268_746,0.48572628043660787,2450,68,2382
3,269_747,0.4970260534472648,3002,173,2829
3,27_38,0.5,12,6,6
3,27_39,0.625,12,4,8
3,270_748,0.49772965420887183,2876,13,2863
3,271_749,0.49155011655011654,349,52,297
3,272_750,0.5069140197152245,686,22,664
3,273_751,0.4925,406,6,400
3,274_752,0.4968291054739653,3015,19,2996
3,275_753,0.4891304347826087,282,6,276
3,275_754,0.49629255139871925,2989,22,2967
3,276_755,0.5068776709401709,2532,36,2496
3,277_756,0.49945770065075923,2769,3,2766
3,278_757,0.49856796116504853,2547,75,2472
3,279_758,0.5327367318892742,2197,14,2183
3,280_759,0.4936051159072742,2534,32,2502
3,281_760,0.4975186104218362,405,2,403
3,283_762,0.49921985815602843,307,25,282
3,37_69,0.33333333333333337,4,1,3
3,42_103,0.25,3,1,2
3,42_104,0.25,3,2,1
3,46_120,0.25,3,1,2
3,49_149,0.33333333333333337,4,1,3
3,5_5,1.0,7,1,6
3,71_212,0.25,3,1,2
3,71_213,0.25,3,2,1
3,78_237,1.0,3,1,2
3,8_12,1.0,4,1,3
3,82_243,0.0,2,1,1
3,85_247,0.5,4,2,2
3,85_248,0.33333333333333337,4,1,3
3,86_249,0.25,3,1,2
3,9_14,0.25,3,1,2
3,9_18,0.25,3,1,2
3,91_257,1.0,4,3,1
3,92_258,1.0,4,3,1
3,93_259,0.5681818181818182,19,8,11
4,10_19,0.47619047619047616,22,1,21
4,10_20,0.4230769230769231,15,2,13
4,100_277,0.3125,11,3,8
4,100_278,0.6071428571428571,11,4,7
4,104_291,0.5,9,3,6
4,105_355,0.6785714285714286,9,2,7
4,105_369,0.4375,9,1,8
4,105_361,0.6785714285714286,9,2,7
4,105_378,0.35714285714285715,9,2,7
4,105_352,0.25,9,3,6
4,104_289,0.5499999999999999,9,4,5
4,105_377,0.4375,9,1,8
4,105_375,0.6785714285714286,9,2,7
4,104_325,0.4666666666666666,8,3,5
4,104_297,0.33333333333333337,8,2,6
4,104_295,1.0,8,1,7
4,104_299,0.2,8,3,5
4,104_300,0.0,2,1,1
4,104_319,0.4285714285714286,8,1,7
4,104_323,0.4666666666666666,8,3,5
4,104_334,0.4285714285714286,8,1,7
4,105_339,0.7750000000000001,9,4,5
4,105_341,0.325,9,4,5
4,105_360,0.25,9,3,6
4,105_362,0.35714285714285715,9,2,7
4,105_374,0.5,9,3,6
4,105_382,0.75,9,3,6
4,105_385,0.4285714285714286,8,1,7
4,105_391,0.4285714285714286,8,1,7
4,106_392,0.4230769230769231,15,2,13
4,11_22,0.375,5,1,4
4,110_396,1.0,5,1,4
4,110_397,0.5714285714285714,32,4,28
4,110_398,0.6333333333333333,33,3,30
4,110_399,0.4482758620689655,32,3,29
4,110_400,0.7321428571428571,30,2,28
4,110_401,0.5714285714285714,32,4,28
4,111_402,0.4722222222222222,19,1,18
4,112_406,0.375,5,1,4
4,113_407,1.0,5,1,4
4,116_411,0.5,25,5,20
4,116_412,0.45454545454545453,24,2,22
4,116_413,0.375,10,2,8
4,116_415,0.33333333333333337,4,1,3
4,116_420,0.47058823529411764,18,1,17
4,116_421,0.6,18,3,15
4,116_424,1.0,17,1,16
4,116_425,0.4736842105263158,20,1,19
4,116_426,0.6190476190476191,24,3,21
4,116_427,0.5614035087719298,25,6,19
4,117_429,0.7333333333333334,20,5,15
4,117_430,0.4736842105263158,20,1,19
4,118_432,0.4285714285714286,16,2,14
4,118_434,0.6666666666666666,8,2,6
4,12_23,0.5333333333333333,14,5,9
4,13_24,0.5333333333333333,14,5,9
4,135_479,0.4166666666666667,7,1,6
4,14_25,0.6888888888888889,14,5,9
4,143_495,0.45714285714285713,19,5,14
4,145_497,0.625,6,2,4
4,15_26,0.4166666666666667,14,2,12
4,153_510,0.45,11,1,10
4,154_511,0.3888888888888889,11,2,9
4,16_27,0.7878787878787877,14,3,11
4,167_539,0.375,10,2,8
4,167_538,0.375,10,2,8
4,168_542,0.3846153846153846,16,3,13
4,168_543,0.3846153846153846,16,3,13
4,169_544,0.3846153846153846,16,3,13
4,169_545,0.4285714285714286,16,2,14
4,169_548,0.4285714285714286,16,2,14
4,169_549,0.619047619047619,16,9,7
4,170_550,0.45,11,1,10
4,178_591,0.4666666666666667,16,1,15
4,178_684,0.5631313131313131,173,11,162
4,179_659,0.49828178694158076,292,1,291
4,18_29,0.6888888888888889,14,5,9
4,180_686,0.6406417112299466,96,11,85
4,183_604,0.5250212044105175,140,9,131
4,184_606,0.5841346153846154,173,13,160
4,185_665,0.4875,164,4,160
4,185_666,0.4810126582278481,164,6,158
4,186_668,0.5541871921182266,181,7,174
4,186_669,0.49441340782122906,181,2,179
4,187_618,0.49330357142857145,227,3,224
4,187_619,0.4583333333333333,26,2,24
4,19_30,0.375,10,2,8
4,190_628,0.5971668880035415,260,9,251
4,190_629,0.49019607843137253,260,5,255
4,190_674,0.492,254,4,250
4,191_630,0.4909090909090909,504,9,495
4,191_631,0.49193548387096775,504,8,496
4,192_635,0.4666666666666667,16,1,15
4,193_723,0.49044585987261147,160,3,157
4,194_639,0.5370317002881845,357,10,347
4,194_678,0.49324324324324326,225,3,222
4,195_642,0.4606075216972034,339,34,305
4,196_644,0.4974315068493151,587,3,584
4,197_645,0.4685185185185185,123,15,108
4,197_646,0.583050847457627,123,5,118
4,197_647,0.34615384615384615,17,4,13
4,197_648,0.7166666666666667,17,2,15
4,197_649,0.5290294150049576,342,29,313
4,197_650,0.4880239520958084,342,8,334
4,197_651,0.49557522123893805,342,3,339
4,198_682,0.49255952380952384,341,21,320
4,199_657,0.48405797101449277,356,11,345
4,201_660,0.45121951219512196,45,4,41
4,202_661,0.4863636363636364,452,12,440
4,204_663,0.49570200573065903,352,3,349
4,205_664,0.48101851851851846,472,40,432
4,206_670,0.48660714285714285,345,9,336
4,206_671,0.48042168674698793,345,13,332
4,207_672,0.5398841354723708,413,17,396
4,208_673,0.4885386819484241,357,8,349
4,209_676,0.497737556561086,444,2,442
4,21_32,0.4166666666666667,7,1,6
4,210_677,0.533625730994152,696,12,684
4,212_680,0.49859550561797755,357,1,356
4,213_681,0.5057688273547305,248,21,227
4,214_683,0.4896449704142012,345,7,338
4,215_685,0.46845425867507884,337,20,317
4,217_688,0.511204481792717,349,34,315
4,217_689,0.4748201438848921,292,14,278
4,219_691,0.4898255813953488,351,7,344
4,220_692,0.5070678319785563,2214,53,2161
4,221_693,0.48987769179491636,3061,93,2968
4,223_695,0.49166666666666664,366,6,360
4,224_696,0.516301703163017,426,15,411
4,225_697,0.49855907780979825,348,1,347
4,227_699,0.4951807228915663,419,4,415
4,228_700,0.4618320610687023,141,10,131
4,229_701,0.48347892676839305,639,61,578
4,23_34,0.4166666666666667,7,1,6
4,230_702,0.49127906976744184,350,6,344
4,231_703,0.4898817029964571,1699,61,1638
4,232_704,0.5244588744588745,338,30,308
4,232_705,0.4783950617283951,338,14,324
4,233_706,0.5013396960056558,2879,50,2829
4,234_707,0.49606113443751815,3072,91,2981
4,235_708,0.4965211030399946,2114,87,2027
4,236_709,0.4806305102858669,432,38,394
4,237_710,0.49056603773584906,432,8,424
4,238_712,0.5002685395579426,2688,103,2585
4,239_713,0.49339757316202715,2839,37,2802
4,240_714,0.4967948208121908,2664,98,2566
4,241_715,0.48938641000156924,2871,140,2731
4,242_716,0.519486654070309,2889,53,2836
4,243_717,0.49527806925498424,2886,27,2859
4,244_718,0.49640015157256534,2658,19,2639
4,245_719,0.4766355140186916,336,15,321
4,246_720,0.4973056197074673,2612,14,2598
4,247_721,0.5153379953379953,2599,25,2574
4,248_722,0.521391443422631,2583,82,2501
4,249_724,0.4925704147261033,2640,135,2505
4,25_36,0.6500000000000001,7,2,5
4,250_725,0.49347014925373134,543,7,536
4,250_726,0.4906191369606004,543,10,533
4,251_727,0.5103841069420937,2642,31,2611
4,253_729,0.5012427506213754,301,17,284
4,254_730,0.5527506963788301,367,8,359
4,257_735,0.47579001019367995,363,36,327
4,258_736,0.49859550561797755,357,1,356
4,259_737,0.4972862957937585,1482,8,1474
4,26_37,0.4166666666666667,7,1,6
4,260_738,0.5077111796143954,2399,146,2253
4,261_739,0.5152977300142559,884,55,829
4,262_740,0.487146529562982,399,10,389
4,263_741,0.46647230320699706,366,23,343
4,264_742,0.4982614742698192,2886,10,2876
4,265_743,0.49695630148887937,2614,143,2471
4,266_744,0.48924008069939473,1519,32,1487
4,267_745,0.4816393442622951,1581,56,1525
4,268_746,0.5030475416497359,2446,92,2354
4,269_747,0.48775429390264397,3022,121,2901
4,27_38,0.2708333333333333,14,6,8
4,27_39,0.7083333333333334,14,2,12
4,270_748,0.4957939011566772,2877,24,2853
4,271_749,0.49694870526142176,305,47,258
4,272_750,0.49110320284697506,572,10,562
4,273_751,0.5535714285714285,400,8,392
4,274_752,0.4956652217405802,3025,26,2999
4,275_753,0.5394265232974911,257,9,248
4,275_754,0.5232926117780173,2996,19,2977
4,276_755,0.49517878666130977,2513,24,2489
4,277_756,0.49910618519842687,2802,5,2797
4,278_757,0.5170302334481439,2524,67,2457
4,279_758,0.49677864703175334,2187,14,2173
4,280_759,0.4943571140669085,2509,28,2481
4,281_760,0.4888268156424581,366,8,358
4,283_762,0.5341549295774649,294,10,284
4,40_95,0.6666666666666666,8,2,6
4,46_120,0.375,5,1,4
4,5_5,1.0,18,1,17
4,7_11,0.5833333333333334,5,2,3
4,70_211,0.4642857142857143,15,1,14
4,8_12,0.375,5,1,4
4,8_13,0.375,5,1,4
4,81_241,0.4722222222222222,19,1,18
4,82_242,0.4117647058823529,20,3,17
4,82_243,0.4285714285714286,8,1,7
4,83_245,0.375,5,1,4
4,84_246,0.375,5,1,4
4,85_247,0.44999999999999996,11,5,6
4,88_254,0.7083333333333334,14,2,12
4,89_255,0.6785714285714286,9,2,7
4,9_18,1.0,7,2,5
4,90_256,0.48214285714285715,29,1,28
4,91_257,1.0,5,1,4
4,92_258,0.375,5,1,4
4,93_259,0.5666666666666667,26,6,20
