Fold,Task,AUC_ROC,AUC_PR,Test_Set_Length,Num_Actives,Num_Inactives
0,1_1,0.6428571428571429,0.1111111111111111,22,1,21
0,10_19,,,17,0,17
0,10_20,,,17,0,17
0,100_277,0.6875,0.25,9,1,8
0,100_278,0.6071428571428571,0.325,9,2,7
0,104_291,0.7692307692307692,0.75,16,3,13
0,105_355,,,16,0,16
0,105_369,0.7666666666666666,0.2,16,1,15
0,105_361,0.7666666666666666,0.2,16,1,15
0,105_378,0.7454545454545455,0.6833333333333333,16,5,11
0,105_352,0.6333333333333333,0.6408730158730158,16,6,10
0,104_289,0.7692307692307692,0.75,16,3,13
0,105_377,,,16,0,16
0,105_375,0.8392857142857143,0.3666666666666667,16,2,14
0,104_325,,,10,0,10
0,104_297,,,10,0,10
0,104_295,,,10,0,10
0,104_299,,,10,0,10
0,104_300,0.7619047619047619,0.6984126984126984,10,3,7
0,104_326,0.6190476190476191,0.5873015873015872,10,3,7
0,104_319,,,10,0,10
0,104_323,1.0,1.0,10,1,9
0,104_334,,,9,0,9
0,105_339,0.7545454545454545,0.7057142857142857,16,5,11
0,105_341,0.8020833333333333,0.7333333333333334,16,4,12
0,105_360,0.6636363636363636,0.5914285714285714,16,5,11
0,105_362,0.7166666666666667,0.7408730158730158,16,6,10
0,105_374,0.75,0.6952380952380952,16,6,10
0,105_382,0.6507936507936507,0.6673469387755102,16,7,9
0,105_385,0.875,0.5,9,1,8
0,105_391,0.875,0.5,9,1,8
0,106_392,0.0625,0.0625,17,1,16
0,108_394,0.6428571428571428,0.6428571428571428,9,2,7
0,109_395,0.1428571428571429,0.19642857142857142,9,2,7
0,11_21,0.35714285714285715,0.2777777777777778,9,2,7
0,11_22,0.35714285714285715,0.2777777777777778,9,2,7
0,110_396,,,6,0,6
0,110_397,0.5486111111111112,0.15433429118773945,40,4,36
0,110_398,0.23774509803921567,0.11257716049382716,40,6,34
0,110_399,0.7612612612612613,0.1736111111111111,40,3,37
0,110_400,0.8157894736842106,0.16666666666666666,40,2,38
0,110_401,0.5657142857142857,0.16083333333333333,40,5,35
0,111_402,0.9629629629629629,0.5833333333333333,29,2,27
0,112_406,0.375,0.16666666666666666,9,1,8
0,113_407,0.475,0.475,9,4,5
0,114_408,0.375,0.16666666666666666,9,1,8
0,115_409,,,13,0,13
0,116_411,0.45499999999999996,0.15598135806046554,29,4,25
0,116_412,0.22321428571428573,0.06274509803921569,30,2,28
0,116_413,,,16,0,16
0,116_414,,,16,0,16
0,116_415,0.65,0.6644444444444445,11,5,6
0,116_416,0.32500000000000007,0.1736111111111111,12,2,10
0,116_420,,,17,0,17
0,116_421,0.6428571428571428,0.26666666666666666,16,2,14
0,116_424,0.5740740740740741,0.1986161986161986,21,3,18
0,116_425,0.875,0.3333333333333333,17,1,16
0,116_426,0.5267857142857142,0.2037037037037037,30,2,28
0,116_427,0.5253623188405797,0.23371881668027714,29,6,23
0,117_429,0.7276785714285714,0.5803030303030303,23,7,16
0,117_430,0.7666666666666666,0.31313131313131315,23,3,20
0,118_432,0.9642857142857143,0.8333333333333333,16,2,14
0,118_434,0.8333333333333334,0.8055555555555556,7,3,4
0,12_23,0.9437500000000001,0.9293650793650794,18,8,10
0,13_24,0.9437500000000001,0.9293650793650794,18,8,10
0,133_474,,,10,0,10
0,134_476,,,7,0,7
0,134_477,,,10,0,10
0,135_479,,,7,0,7
0,14_25,1.0,1.0,18,5,13
0,143_495,0.6428571428571429,0.2777777777777778,17,3,14
0,145_497,0.6666666666666667,0.3333333333333333,11,2,9
0,15_26,0.8823529411764706,0.3333333333333333,18,1,17
0,153_510,0.9,0.5,11,1,10
0,154_511,0.8888888888888888,0.5,10,1,9
0,16_27,0.9076923076923078,0.8600000000000001,18,5,13
0,160_519,,,41,0,41
0,167_539,0.6,0.2,11,1,10
0,167_538,0.6,0.2,11,1,10
0,168_541,0.888888888888889,0.6666666666666666,20,2,18
0,168_542,0.8571428571428571,0.3333333333333333,15,1,14
0,168_543,0.7307692307692307,0.29166666666666663,15,2,13
0,169_544,0.8125,0.3611111111111111,22,2,20
0,169_545,0.7619047619047619,0.16666666666666666,22,1,21
0,169_548,0.625,0.16666666666666666,22,2,20
0,169_549,0.828125,0.5537037037037037,22,6,16
0,17_28,,,16,0,16
0,170_550,0.75,0.29166666666666663,17,2,15
0,170_551,0.0,0.058823529411764705,17,1,16
0,174_555,0.7,0.14285714285714285,21,1,20
0,175_559,0.75,0.3333333333333333,9,1,8
0,175_561,0.75,0.3333333333333333,9,1,8
0,177_585,0.3338607594936709,0.007312735573605138,318,2,316
0,178_591,,,18,0,18
0,178_684,0.6701859439016703,0.4600416070174284,186,19,167
0,179_659,0.7237136465324385,0.022458017023234415,301,3,298
0,18_29,0.8303571428571428,0.5111111111111111,18,4,14
0,180_686,0.7680102915951972,0.37080507294037957,117,11,106
0,181_599,0.16666666666666663,0.09090909090909091,13,1,12
0,181_600,0.16666666666666663,0.09090909090909091,13,1,12
0,183_604,0.692391304347826,0.4620158683975838,148,10,138
0,184_606,0.774825550187869,0.506258239560524,185,23,162
0,185_665,0.5754414125200642,0.14838249478940813,185,7,178
0,185_666,0.5603813559322034,0.13942834467321125,185,8,177
0,185_667,,,185,0,185
0,186_668,0.9339539007092198,0.7074999999999999,194,6,188
0,186_669,0.8592105263157894,0.6122967479674797,194,4,190
0,187_618,,,215,0,215
0,187_619,,,46,0,46
0,19_30,0.9791666666666666,0.95,16,4,12
0,190_628,0.4318532818532818,0.13096807738570215,269,10,259
0,190_629,0.47316919191919193,0.030253679933392313,270,6,264
0,190_674,0.3859477124183006,0.02937333576719766,261,6,255
0,191_630,0.5084269662921348,0.027391246410965683,546,12,534
0,191_631,0.4761194029850747,0.02074468552137624,546,10,536
0,191_675,0.5,0.009174311926605505,203,1,202
0,192_635,0.9111111111111111,0.8095238095238095,18,3,15
0,193_723,0.7390909090909091,0.17293830288369877,175,10,165
0,194_639,0.4646746011648519,0.029507201313304875,370,11,359
0,194_678,0.6953216374269006,0.026205373573794627,288,3,285
0,195_642,0.48737794713026916,0.08938047214749792,349,26,323
0,196_644,0.6751937984496124,0.0047169811320754715,646,1,645
0,197_645,0.5886948529411764,0.13759122802839374,145,17,128
0,197_646,0.5674019607843137,0.07534341000253686,145,9,136
0,197_647,0.6388888888888888,0.29365079365079366,22,4,18
0,197_648,0.9047619047619048,0.3333333333333333,22,1,21
0,197_649,0.547137458006719,0.1507124647989883,351,47,304
0,197_650,0.4925226586102719,0.05628505811954789,351,20,331
0,197_651,0.5306763285024155,0.03130435255649032,351,6,345
0,198_682,0.7778552414754721,0.28876257113052295,366,23,343
0,199_657,0.6152506963788301,0.11852838007953898,375,16,359
0,200_658,,,3,0,3
0,201_660,0.9850746268656716,0.5,68,1,67
0,202_661,0.9678871548619448,0.6279561426530196,483,7,476
0,203_662,0.6743659420289855,0.018785142651817147,371,3,368
0,204_663,0.6702702702702703,0.008,371,1,370
0,205_664,0.6459195402298848,0.2735932018854622,495,60,435
0,206_670,0.5920726672171759,0.05650538136025378,353,7,346
0,206_671,0.6154692082111437,0.0816065509882311,353,12,341
0,207_672,0.5641456582633053,0.07509198079928961,437,17,420
0,208_673,0.600587084148728,0.04326987981488549,372,7,365
0,209_676,0.4524291497975709,0.0033112582781456954,495,1,494
0,21_32,,,13,0,13
0,210_677,0.43432400932400933,0.015833378218450433,727,12,715
0,212_680,0.4653333333333334,0.008550947260624681,377,2,375
0,213_681,0.4465358784022623,0.07845794434470904,269,23,246
0,214_683,0.5314245810055865,0.015874363327674022,362,4,358
0,215_685,0.7304953231292517,0.47705161352181463,416,24,392
0,216_687,0.4578666666666667,0.017582678139532116,380,5,375
0,217_688,0.6350899651518384,0.2167410539368146,370,43,327
0,217_689,0.7811188811188812,0.2540510523746979,301,15,286
0,219_691,0.45687331536388137,0.01174246394530544,375,4,371
0,220_692,0.5419569937775472,0.02775344589686827,2260,56,2204
0,221_693,0.6019211403569692,0.05261275365512651,3069,77,2992
0,223_695,0.5981675392670157,0.011773940345368918,384,2,382
0,224_696,0.5145801910507792,0.03925667231963102,485,17,468
0,225_697,0.5146780303030303,0.012566137566137567,355,3,352
0,227_699,0.6686337625178828,0.045637408178465066,472,6,466
0,228_700,0.4585755813953489,0.1296216205623429,145,16,129
0,229_701,0.5391002816602009,0.12773117498499872,669,62,607
0,23_34,0.16666666666666663,0.09090909090909091,13,1,12
0,230_702,0.6741573033707865,0.18760071211555482,366,10,356
0,231_703,0.6017980714690868,0.08011684388551978,1813,50,1763
0,232_704,0.7166128419452887,0.24438642003111347,361,32,329
0,232_705,0.6733071135430917,0.18156778333623225,361,17,344
0,233_706,0.6355065251050652,0.06155625368436827,2921,44,2877
0,234_707,0.5537627978183906,0.045496015205584946,3084,98,2986
0,235_708,0.6176260202147369,0.06028280725841331,2040,71,1969
0,236_709,0.6593470982142857,0.22552434080282976,488,40,448
0,237_710,0.4929102742910274,0.020734362948766925,487,9,478
0,237_711,0.7085561497326203,0.017857142857142856,188,1,187
0,238_712,0.5906811555980069,0.057222324802463365,2753,106,2647
0,239_713,0.4814465876597081,0.02492159743849817,2857,43,2814
0,24_35,,,13,0,13
0,240_714,0.6542885356253737,0.06803518344502543,2771,108,2663
0,241_715,0.45146936396936393,0.03834846407752272,2902,130,2772
0,242_716,0.539382547846122,0.022049549472049613,2910,49,2861
0,243_717,0.5127319517811187,0.010012122039562187,2912,23,2889
0,244_718,0.49403966808338395,0.007710766484037221,2763,18,2745
0,245_719,0.6036739380022963,0.15754218767683775,361,26,335
0,246_720,0.6439584877687177,0.021267862024884888,2718,20,2698
0,247_721,0.48880500709769004,0.009445774763338959,2607,24,2583
0,248_722,0.5006980056980057,0.025650036210034227,2654,54,2600
0,249_724,0.509958364202746,0.03396662584811025,2740,87,2653
0,25_36,,,13,0,13
0,250_725,,,613,0,613
0,250_726,0.7904351395730707,0.047828353210612747,613,4,609
0,251_727,0.5172243423742674,0.00444252064040076,2679,11,2668
0,253_729,0.6592492872980678,0.1452902777856165,309,22,287
0,254_730,0.9000770119368502,0.2673495754891103,378,7,371
0,257_735,0.5411153472377963,0.16363025877006288,382,39,343
0,258_736,0.3763440860215053,0.011221862431182426,375,3,372
0,259_737,0.4635552505147564,0.00514124741112737,1462,5,1457
0,26_37,,,13,0,13
0,260_738,0.520311945689683,0.04020425133370332,2557,101,2456
0,261_739,0.4718177829191432,0.058438672050287396,999,53,946
0,262_740,0.7690854119425548,0.16703178884537803,450,9,441
0,263_741,0.5287766830870279,0.10749767337817641,383,35,348
0,264_742,0.5485300846488218,0.03371939954327776,2920,6,2914
0,265_743,0.5544865211810014,0.086808214856306,2539,164,2375
0,266_744,0.5401474252491695,0.02331874013254262,1537,32,1505
0,267_745,0.6555746031746031,0.06159193176739111,1795,45,1750
0,268_746,0.4988971157718642,0.025804163531611014,2548,65,2483
0,269_747,0.5551698853464366,0.04888368813594959,3025,108,2917
0,27_38,0.5954545454545455,0.6945444905971221,21,10,11
0,27_39,0.8796296296296297,0.6095238095238096,21,3,18
0,27_40,0.4666666666666667,0.1111111111111111,16,1,15
0,270_748,0.5117897727272727,0.00987866312409997,2902,22,2880
0,271_749,0.5907674772036474,0.17613991560572811,369,40,329
0,272_750,0.5932671081677704,0.03383643807890499,619,15,604
0,273_751,0.40638803941556234,0.02324464427076392,336,9,327
0,274_752,0.613671288373555,0.03245143021919567,3033,19,3014
0,275_753,0.7286324786324786,0.21184140620667088,285,12,273
0,275_754,0.5538969778539092,0.06988128638448736,2994,22,2972
0,276_755,0.532940708199428,0.014846478392926058,2635,26,2609
0,277_756,0.5152787579393084,0.04781540011982643,2839,5,2834
0,278_757,0.5820272516410147,0.04404697869856033,2649,83,2566
0,279_758,0.48035872453498674,0.00750510043837992,2268,10,2258
0,280_759,0.712142213207122,0.029186425653458182,2644,34,2610
0,281_760,0.46596534653465344,0.02243135621914223,410,6,404
0,283_762,0.5635338345864662,0.12918700893891136,313,28,285
0,29_43,0.9230769230769231,0.5,14,1,13
0,3_3,0.9,0.5,11,1,10
0,37_69,0.875,0.5,9,1,8
0,37_70,0.875,0.5,9,1,8
0,37_74,1.0,1.0,9,2,7
0,37_77,0.5,0.2,9,1,8
0,40_95,0.875,0.5,9,1,8
0,40_96,0.875,0.5,9,1,8
0,42_103,,,9,0,9
0,42_104,,,9,0,9
0,44_106,,,9,0,9
0,46_120,0.7777777777777778,0.7222222222222222,9,3,6
0,49_149,,,9,0,9
0,5_5,0.5833333333333334,0.1994949494949495,21,3,18
0,50_154,,,4,0,4
0,53_178,0.375,0.16666666666666666,9,1,8
0,54_179,,,7,0,7
0,54_182,,,7,0,7
0,6_7,,,10,0,10
0,7_10,0.7777777777777778,0.3333333333333333,10,1,9
0,7_11,0.6875,0.3666666666666667,10,2,8
0,70_211,,,13,0,13
0,71_212,0.7142857142857143,0.6666666666666666,9,2,7
0,71_213,0.8333333333333334,0.8333333333333333,9,3,6
0,76_230,0.3846153846153846,0.1111111111111111,14,1,13
0,78_237,,,9,0,9
0,8_12,0.8571428571428572,0.7555555555555555,10,3,7
0,8_13,0.8571428571428572,0.7555555555555555,10,3,7
0,80_239,0.4166666666666667,0.24206349206349206,13,3,10
0,81_241,,,16,0,16
0,82_242,0.8157894736842105,0.4242424242424242,23,4,19
0,82_243,0.2857142857142857,0.16666666666666666,8,1,7
0,83_244,,,13,0,13
0,83_245,,,9,0,9
0,84_246,,,9,0,9
0,85_247,0.8125,0.7986111111111112,12,4,8
0,85_248,,,13,0,13
0,86_249,0.375,0.16666666666666666,9,1,8
0,86_250,,,9,0,9
0,88_252,,,22,0,22
0,88_254,0.8928571428571428,0.5,16,2,14
0,89_255,,,15,0,15
0,9_14,,,6,0,6
0,9_17,1.0,1.0,8,1,7
0,9_18,,,6,0,6
0,90_256,,,35,0,35
0,91_257,0.8095238095238095,0.5888888888888889,10,3,7
0,92_258,0.8095238095238095,0.5888888888888889,10,3,7
0,93_259,0.35869565217391297,0.23175770589563693,29,6,23
1,1_1,1.0,1.0,11,1,10
1,10_19,0.7142857142857143,0.3333333333333333,8,1,7
1,10_20,,,6,0,6
1,100_277,0.8,0.5,6,1,5
1,100_278,0.22222222222222224,0.4666666666666667,6,3,3
1,104_291,1.0,1.0,7,2,5
1,105_355,0.8333333333333334,0.5,7,1,6
1,105_369,0.8333333333333334,0.5,7,1,6
1,105_361,,,7,0,7
1,105_378,0.6,0.6666666666666666,7,2,5
1,105_352,0.16666666666666663,0.16666666666666666,7,1,6
1,104_289,0.8333333333333334,0.5,7,1,6
1,105_377,,,7,0,7
1,105_375,0.8333333333333334,0.5,7,1,6
1,104_325,,,3,0,3
1,104_297,,,3,0,3
1,104_295,,,3,0,3
1,104_299,1.0,1.0,3,1,2
1,104_300,1.0,1.0,4,1,3
1,104_326,1.0,1.0,4,1,3
1,104_319,,,3,0,3
1,104_323,1.0,1.0,3,2,1
1,104_334,,,3,0,3
1,105_339,1.0,1.0,7,1,6
1,105_341,0.75,0.8333333333333333,7,3,4
1,105_360,0.8333333333333334,0.5,7,1,6
1,105_362,0.8333333333333334,0.5,7,1,6
1,105_374,1.0,1.0,7,2,5
1,105_382,0.5,0.41666666666666663,7,2,5
1,105_385,,,3,0,3
1,105_391,,,3,0,3
1,106_392,0.0,0.16666666666666666,6,1,5
1,108_394,0.75,0.5,5,1,4
1,109_395,0.75,0.5,5,1,4
1,11_21,0.5,0.5,3,1,2
1,11_22,,,3,0,3
1,110_396,,,2,0,2
1,110_397,0.5166666666666667,0.10416666666666666,32,2,30
1,110_398,0.5642857142857144,0.18952380952380954,33,5,28
1,110_399,0.20588235294117652,0.03571428571428571,35,1,34
1,110_400,,,33,0,33
1,110_401,0.6451612903225806,0.08333333333333333,32,1,31
1,111_402,0.9333333333333333,0.8303571428571428,19,4,15
1,112_406,,,3,0,3
1,113_407,1.0,1.0,3,1,2
1,114_408,,,3,0,3
1,115_409,,,6,0,6
1,116_411,0.575,0.22549019607843135,22,2,20
1,116_412,0.625,0.32484917043740574,22,4,18
1,116_413,,,8,0,8
1,116_414,,,8,0,8
1,116_415,,,6,0,6
1,116_416,0.33333333333333337,0.3333333333333333,4,1,3
1,116_420,0.25,0.14285714285714285,9,1,8
1,116_421,,,9,0,9
1,116_424,,,8,0,8
1,116_425,0.625,0.25,9,1,8
1,116_426,0.631578947368421,0.2569444444444444,22,3,19
1,116_427,0.9,0.41666666666666663,22,2,20
1,117_429,0.5,0.625,8,2,6
1,117_430,,,8,0,8
1,118_432,0.8235294117647058,0.6388888888888888,20,3,17
1,118_434,0.5,0.8333333333333333,3,2,1
1,12_23,0.6,0.45,7,2,5
1,13_24,0.5833333333333334,0.5333333333333333,7,3,4
1,133_474,,,4,0,4
1,134_476,1.0,1.0,2,1,1
1,134_477,,,4,0,4
1,135_479,,,2,0,2
1,14_25,0.8333333333333334,0.5,7,1,6
1,143_495,0.7857142857142857,0.7,9,2,7
1,145_497,,,3,0,3
1,15_26,,,7,0,7
1,153_510,,,4,0,4
1,154_511,,,4,0,4
1,16_27,,,7,0,7
1,160_519,,,44,0,44
1,167_539,,,4,0,4
1,167_538,,,4,0,4
1,168_541,0.5416666666666666,0.14285714285714285,13,1,12
1,168_542,0.5,0.25,7,1,6
1,168_543,0.5,0.25,7,1,6
1,169_544,0.75,0.7,8,2,6
1,169_545,0.4285714285714286,0.2,8,1,7
1,169_548,0.4285714285714286,0.2,8,1,7
1,169_549,0.8571428571428572,0.5,8,1,7
1,17_28,0.8333333333333334,0.5,7,1,6
1,170_550,0.0,0.2,5,1,4
1,170_551,,,5,0,5
1,174_555,,,12,0,12
1,175_559,,,3,0,3
1,175_561,,,3,0,3
1,177_585,0.4204343971631206,0.017592306335541152,382,6,376
1,178_591,,,7,0,7
1,178_684,0.6364155251141552,0.30929866942532835,158,12,146
1,179_659,0.3917112299465241,0.00423728813559322,375,1,374
1,18_29,0.8333333333333334,0.5,7,1,6
1,180_686,0.7537393162393162,0.2672016312614569,113,9,104
1,181_599,0.4,0.25,6,1,5
1,181_600,,,6,0,6
1,183_604,0.7841530054644809,0.06928755998523439,125,3,122
1,184_606,0.8315649867374005,0.5099903064652378,158,13,145
1,185_665,0.5907320872274143,0.16201399924029058,220,6,214
1,185_666,0.48183254344391785,0.1242236702900162,220,9,211
1,185_667,0.9908675799086758,0.3333333333333333,220,1,219
1,186_668,0.712755356253114,0.41910022477326087,232,9,223
1,186_669,0.17748917748917747,0.005050505050505051,232,1,231
1,187_618,,,264,0,264
1,187_619,0.1428571428571429,0.05263157894736842,22,1,21
1,19_30,,,7,0,7
1,190_628,0.6564356435643565,0.033276370700841953,308,5,303
1,190_629,0.8283991228070176,0.046680902265832866,307,3,304
1,190_674,0.7309144295302014,0.07349183055186209,306,8,298
1,191_630,0.40521726901982846,0.0214540790436469,560,13,547
1,191_631,0.38494243851386706,0.02833260409042137,560,14,546
1,191_675,0.08906250000000002,0.012312177648500518,244,4,240
1,192_635,,,7,0,7
1,193_723,0.6731234866828087,0.1456635693008936,191,14,177
1,194_639,0.6185507246376811,0.04332637435219818,355,10,345
1,194_678,0.40476190476190477,0.009305071022213039,360,3,357
1,195_642,0.5193125000000001,0.11747765959496324,345,25,320
1,196_644,0.6353677621283256,0.011065165599812785,643,4,639
1,197_645,0.42560348239018597,0.14243686043842718,152,19,133
1,197_646,0.5755102040816328,0.04342558217873856,152,5,147
1,197_647,0.15000000000000002,0.14583333333333331,12,2,10
1,197_648,,,12,0,12
1,197_649,0.4774005756148614,0.20398057053810842,346,52,294
1,197_650,0.5464365881032547,0.13570961518046254,346,22,324
1,197_651,0.9475218658892128,0.3958048335613315,346,3,343
1,198_682,0.7889890282131662,0.34544549637001776,343,24,319
1,199_657,0.496943115364168,0.03624383399091283,353,11,342
1,200_658,,,3,0,3
1,201_660,,,35,0,35
1,202_661,0.8236383442265796,0.43827719041359325,469,10,459
1,203_662,0.41189111747851004,0.014428119772947359,353,4,349
1,204_663,,,353,0,353
1,205_664,0.7484278577725536,0.208559348281907,456,41,415
1,206_670,0.3042899408284024,0.021335838731491,348,10,338
1,206_671,0.43136094674556213,0.028169375405444567,348,10,338
1,207_672,0.4455585264408794,0.0406637882034418,413,17,396
1,208_673,0.7595880681818181,0.12364218424694758,360,8,352
1,209_676,0.4871031746031746,0.01000309927691673,508,4,504
1,21_32,,,5,0,5
1,210_677,0.42232355018945483,0.029056800185544573,700,23,677
1,212_680,0.47759103641456585,0.0051813471502590676,358,1,357
1,213_681,0.4924442101563873,0.07435955406328608,292,21,271
1,214_683,0.39309210526315785,0.024679691428783884,350,8,342
1,215_685,0.8275637996219282,0.511219557861301,391,23,368
1,216_687,0.4750598563447725,0.022960284442133046,365,7,358
1,217_688,0.5418952903520805,0.11988564579889986,351,27,324
1,217_689,0.7084165834165834,0.08025525842776277,375,11,364
1,219_691,0.42025862068965514,0.035141877017022,354,6,348
1,220_692,0.481724266857403,0.06791873137641415,2253,56,2197
1,221_693,0.6088438732221604,0.0697869834137007,3071,113,2958
1,223_695,0.6752793296089385,0.07769936246690914,366,8,358
1,224_696,0.5767486601621549,0.05814864701759081,402,19,383
1,225_697,0.6744186046511628,0.04052992205179784,347,3,344
1,227_699,0.5408163265306123,0.005494505494505495,393,1,392
1,228_700,0.5917312661498708,0.18341125701362762,141,12,129
1,229_701,0.49824400671858304,0.13453025207256208,725,59,666
1,23_34,0.0,0.2,5,1,4
1,230_702,0.4665697674418604,0.022703120613490828,351,7,344
1,231_703,0.57518446880149,0.046811394152533076,1829,47,1782
1,232_704,0.7328397673188789,0.36317881338981484,336,31,305
1,232_705,0.7458961845607808,0.21957733837623167,336,14,322
1,233_706,0.6451780797385328,0.02440436125922162,2913,31,2882
1,234_707,0.5572024593763725,0.0410309679697681,3089,99,2990
1,235_708,0.6693566655340356,0.10766493819964473,2052,90,1962
1,236_709,0.6154217404217406,0.2523118214652746,401,37,364
1,237_710,0.8101145038167938,0.20773997321834656,401,8,393
1,237_711,0.6458333333333334,0.06666666666666667,134,2,132
1,238_712,0.554487875934555,0.04822842938731913,2659,97,2562
1,239_713,0.5459540012279983,0.015043069239537712,2820,28,2792
1,24_35,0.16666666666666666,0.5333333333333333,5,3,2
1,240_714,0.6562506482998983,0.10284836609006384,2651,114,2537
1,241_715,0.47056410809935645,0.04493438051595883,2842,137,2705
1,242_716,0.45598336304218656,0.019471701969836698,2865,60,2805
1,243_717,0.4311917850053444,0.012913655597229585,2869,37,2832
1,244_718,0.44519049415314976,0.005347814770583249,2656,5,2651
1,245_719,0.4741878059635069,0.06505728205263313,342,21,321
1,246_720,0.5718976708667431,0.02309717214804149,2634,15,2619
1,247_721,0.5349031162604874,0.01725933046658993,2543,40,2503
1,248_722,0.5100967321571772,0.031034070313157965,2574,80,2494
1,249_724,0.5179981434155976,0.04274282648853506,2634,107,2527
1,25_36,0.25,0.25,5,1,4
1,250_725,0.5761455525606469,0.00879250345138441,746,4,742
1,250_726,0.6701576576576577,0.024627597592419188,746,6,740
1,251_727,0.7447683746970265,0.03400867524824342,2674,11,2663
1,253_729,0.6031932773109243,0.1058380560949285,367,17,350
1,254_730,0.9777777777777777,0.4309523809523809,364,4,360
1,257_735,0.5792307692307692,0.16143057620642787,361,36,325
1,258_736,0.4105461393596987,0.010759175465057818,357,3,354
1,259_737,0.47707618393960194,0.003756437016525021,1462,5,1457
1,26_37,,,5,0,5
1,260_738,0.5522675534316677,0.040765138410961764,2504,88,2416
1,261_739,0.5918322709661292,0.08457338388327204,943,54,889
1,262_740,0.6657678479712379,0.056552642217889866,365,11,354
1,263_741,0.6257971014492754,0.07642181988578696,365,20,345
1,264_742,0.7281544914365606,0.005657158880699536,2867,6,2861
1,265_743,0.5512646978397593,0.08784612184730507,2588,150,2438
1,266_744,0.5659873367629601,0.03263726853927344,1479,35,1444
1,267_745,0.5771185830513357,0.041723462007929424,1658,43,1615
1,268_746,0.5933393529547376,0.048932306554434785,2454,88,2366
1,269_747,0.6110426839902336,0.06212952852072992,3022,94,2928
1,27_38,0.6944444444444444,0.7404093567251463,19,10,9
1,27_39,0.6282051282051282,0.4415204678362573,19,6,13
1,27_40,,,12,0,12
1,270_748,0.5748926449293453,0.03198439015775703,2889,28,2861
1,271_749,0.5027612201963534,0.20346848842524157,294,46,248
1,272_750,0.3737864077669903,0.021722021832653177,740,19,721
1,273_751,0.445364238410596,0.02950499121846302,311,9,302
1,274_752,0.43561867845678637,0.006481671625314869,3024,22,3002
1,275_753,0.8474178403755869,0.4815958815958816,219,6,213
1,275_754,0.4842730405454945,0.00821947142855595,2988,23,2965
1,276_755,0.46852696272799366,0.010090847823518375,2542,20,2522
1,277_756,0.683126110124334,0.002167545720000016,2818,3,2815
1,278_757,0.48710273279352223,0.04332147109258556,2550,80,2470
1,279_758,0.5477226123159138,0.008498867574403605,2313,14,2299
1,280_759,0.6548920511802608,0.02079683414931474,2545,26,2519
1,281_760,0.5925925925925926,0.015278325039281214,345,3,342
1,283_762,0.6971830985915494,0.1428483969113329,303,19,284
1,29_43,,,4,0,4
1,3_3,,,4,0,4
1,37_69,,,3,0,3
1,37_70,,,3,0,3
1,37_74,0.5,0.5,3,1,2
1,37_77,,,3,0,3
1,40_95,,,3,0,3
1,40_96,,,3,0,3
1,42_103,,,3,0,3
1,42_104,,,3,0,3
1,44_106,,,3,0,3
1,46_120,1.0,1.0,3,2,1
1,49_149,,,3,0,3
1,5_5,0.5,0.2,9,1,8
1,50_154,,,1,1,0
1,53_178,,,3,0,3
1,54_179,,,5,0,5
1,54_182,,,3,0,3
1,6_7,1.0,1.0,6,1,5
1,7_10,,,3,0,3
1,7_11,0.5,0.5,3,1,2
1,70_211,0.33333333333333337,0.2,7,1,6
1,71_212,0.5,0.5,3,1,2
1,71_213,1.0,1.0,3,2,1
1,76_230,,,4,0,4
1,78_237,,,3,0,3
1,8_12,0.5,0.5,3,1,2
1,8_13,0.5,0.5,3,1,2
1,80_239,,,5,0,5
1,81_241,,,9,0,9
1,82_242,0.9166666666666667,0.8333333333333333,8,2,6
1,82_243,,,1,0,1
1,83_244,,,7,0,7
1,83_245,0.5,0.5,3,1,2
1,84_246,,,3,0,3
1,85_247,0.75,0.8333333333333333,4,2,2
1,85_248,,,6,0,6
1,86_249,,,3,0,3
1,86_250,,,3,0,3
1,88_252,0.8,0.3333333333333333,11,1,10
1,88_254,0.6666666666666667,0.3333333333333333,7,1,6
1,89_255,0.4,0.25,6,1,5
1,9_14,,,2,0,2
1,9_17,,,1,0,1
1,9_18,,,2,0,2
1,90_256,0.98,0.8333333333333333,27,2,25
1,91_257,1.0,1.0,3,2,1
1,92_258,1.0,1.0,3,2,1
1,93_259,0.6235294117647059,0.4411813186813187,22,5,17
2,1_1,,,30,0,30
2,10_19,,,23,0,23
2,10_20,0.75,0.2,17,1,16
2,100_277,1.0,1.0,10,1,9
2,100_278,1.0,1.0,12,3,9
2,104_291,,,14,0,14
2,105_355,0.9230769230769231,0.5,14,1,13
2,105_369,,,15,0,15
2,105_361,0.9230769230769231,0.5,14,1,13
2,105_378,,,14,0,14
2,105_352,1.0,1.0,14,1,13
2,104_289,,,14,0,14
2,105_377,,,14,0,14
2,105_375,0.9230769230769231,0.5,14,1,13
2,104_325,0.875,0.5,9,1,8
2,104_297,,,9,0,9
2,104_295,,,10,0,10
2,104_299,0.75,0.3333333333333333,9,1,8
2,104_300,,,9,0,9
2,104_326,,,9,0,9
2,104_319,,,10,0,10
2,104_323,0.9285714285714286,0.8333333333333333,9,2,7
2,104_334,,,10,0,10
2,105_339,0.625,0.35,14,2,12
2,105_341,0.9230769230769231,0.5,14,1,13
2,105_360,,,14,0,14
2,105_362,1.0,1.0,14,1,13
2,105_374,,,14,0,14
2,105_382,1.0,1.0,14,1,13
2,105_385,0.7777777777777778,0.3333333333333333,10,1,9
2,105_391,1.0,1.0,10,1,9
2,106_392,,,17,0,17
2,108_394,0.0,0.09090909090909091,11,1,10
2,109_395,0.3333333333333333,0.28535353535353536,11,3,8
2,11_21,,,12,0,12
2,11_22,,,12,0,12
2,110_396,,,2,0,2
2,110_397,0.019230769230769246,0.03721075672295185,41,2,39
2,110_398,0.618421052631579,0.11489898989898989,41,3,38
2,110_399,0.6341463414634146,0.0625,42,1,41
2,110_400,0.65,0.06666666666666667,41,1,40
2,110_401,0.5055555555555555,0.18477382520860783,41,5,36
2,111_402,1.0,1.0,25,1,24
2,112_406,,,11,0,11
2,113_407,1.0,1.0,11,1,10
2,114_408,,,11,0,11
2,115_409,,,14,0,14
2,116_411,0.27419354838709675,0.061553030303030304,33,2,31
2,116_412,0.25,0.05718954248366013,34,2,32
2,116_413,0.0,0.06666666666666667,15,1,14
2,116_414,0.0,0.06666666666666667,15,1,14
2,116_415,0.0,0.08333333333333333,12,1,11
2,116_416,0.45454545454545453,0.3269230769230769,13,2,11
2,116_420,0.6,0.1111111111111111,21,1,20
2,116_421,0.0,0.047619047619047616,21,1,20
2,116_424,1.0,1.0,19,1,18
2,116_425,,,23,0,23
2,116_426,0.5416666666666667,0.17524509803921567,34,4,30
2,116_427,0.4913793103448276,0.1537858422939068,33,4,29
2,117_429,1.0,1.0,22,2,20
2,117_430,0.9523809523809523,0.5,22,1,21
2,118_432,,,19,0,19
2,118_434,0.4285714285714286,0.29166666666666663,9,2,7
2,12_23,0.4642857142857143,0.3125,16,2,14
2,13_24,0.4642857142857143,0.3125,16,2,14
2,133_474,,,12,0,12
2,134_476,,,2,0,2
2,134_477,0.41666666666666663,0.125,13,1,12
2,135_479,,,2,0,2
2,14_25,0.4642857142857143,0.3125,16,2,14
2,143_495,0.9166666666666666,0.5888888888888889,19,3,16
2,145_497,,,10,0,10
2,15_26,,,16,0,16
2,153_510,,,11,0,11
2,154_511,1.0,1.0,11,2,9
2,16_27,0.0,0.0625,16,1,15
2,160_519,,,42,0,42
2,167_539,0.9090909090909091,0.5,12,1,11
2,167_538,0.9090909090909091,0.5,12,1,11
2,168_541,,,29,0,29
2,168_542,0.47916666666666663,0.23054070112893643,19,3,16
2,168_543,0.9166666666666666,0.7222222222222222,19,3,16
2,169_544,0.9375,0.75,18,2,16
2,169_545,1.0,1.0,18,1,17
2,169_548,,,18,0,18
2,169_549,1.0,1.0,18,4,14
2,17_28,,,13,0,13
2,170_550,1.0,1.0,15,1,14
2,170_551,1.0,1.0,15,1,14
2,174_555,1.0,1.0,25,1,24
2,175_559,,,11,0,11
2,175_561,,,11,0,11
2,177_585,0.4185185185185185,0.00625,271,1,270
2,178_591,,,20,0,20
2,178_684,0.5069930069930069,0.07375451181869873,193,11,182
2,179_659,0.6696787148594379,0.017549261083743842,251,2,249
2,18_29,1.0,1.0,16,2,14
2,180_686,0.4803822937625754,0.0702760959099211,149,7,142
2,181_599,,,9,0,9
2,181_600,,,9,0,9
2,183_604,0.6128078817733991,0.09228192073755125,152,7,145
2,184_606,0.801470588235294,0.4201735250987847,193,17,176
2,185_665,0.02083333333333337,0.008403361344537815,121,1,120
2,185_666,0.40536723163841804,0.031181139122315592,121,3,118
2,185_667,,,121,0,121
2,186_668,0.6918238993710693,0.07506942108708467,164,5,159
2,186_669,,,164,0,164
2,187_618,0.5427480916030535,0.06048314863848844,136,5,131
2,187_619,0.9736842105263158,0.75,40,2,38
2,19_30,0.0,0.07692307692307693,13,1,12
2,190_628,0.4911634756995582,0.04084818964789266,201,7,194
2,190_629,0.5505102040816326,0.07604993788148869,201,5,196
2,190_674,0.5561403508771929,0.022014095171530086,193,3,190
2,191_630,0.5940594059405941,0.01792230968349483,511,6,505
2,191_631,0.6383219954648526,0.02463115911607236,511,7,504
2,191_675,0.36,0.01488095238095238,152,2,150
2,192_635,0.1388888888888889,0.08571428571428572,20,2,18
2,193_723,0.5539772727272727,0.1682080136500078,171,11,160
2,194_639,0.5738866396761134,0.084298995422748,393,13,380
2,194_678,0.48019801980198024,0.03075446276547738,207,5,202
2,195_642,0.638314606741573,0.2631461350927306,381,25,356
2,196_644,0.6164440734557597,0.00632131026867869,601,2,599
2,197_645,0.5063657407407407,0.15983000757575483,84,12,72
2,197_646,0.5746835443037975,0.07582208895552224,84,5,79
2,197_647,0.9230769230769231,0.3333333333333333,27,1,26
2,197_648,0.9230769230769231,0.3333333333333333,27,1,26
2,197_649,0.5919038873584329,0.26643411766210434,231,33,198
2,197_650,0.5711929631665751,0.10299717362914643,231,17,214
2,197_651,0.8451327433628318,0.12790953730889945,231,5,226
2,198_682,0.6660608814175375,0.25746855507422345,386,31,355
2,199_657,0.5029212432811405,0.11950298170115181,400,11,389
2,200_658,1.0,1.0,10,4,6
2,201_660,0.921875,0.5158730158730158,67,3,64
2,202_661,0.8474046278924328,0.3069656049241056,539,6,533
2,203_662,0.675771208226221,0.024752861696732596,393,4,389
2,204_663,0.9974293059125964,0.5,390,1,389
2,205_664,0.5918192918192918,0.1395402476893349,500,45,455
2,206_670,0.487280701754386,0.027002370492793068,386,6,380
2,206_671,0.4351677346400301,0.01742155319342526,386,7,379
2,207_672,0.3122222222222222,0.016329310274601782,306,6,300
2,208_673,0.6560374149659863,0.03072463768115942,395,3,392
2,209_676,0.811626195732156,0.023797065331624623,456,3,453
2,21_32,,,13,0,13
2,210_677,0.5520066889632107,0.05122704214971024,623,25,598
2,212_680,0.7826267664172901,0.025850231202277675,404,3,401
2,213_681,0.4119280613594287,0.0732813484554027,218,19,199
2,214_683,0.3948618307426598,0.014098352454739279,392,6,386
2,215_685,0.7165620770271933,0.37358300117755555,328,27,301
2,216_687,0.5363562091503268,0.01938458898350168,414,6,408
2,217_688,0.5841168091168092,0.15397022759085854,391,40,351
2,217_689,0.5982712765957446,0.09770287852681692,251,16,235
2,219_691,0.4773869346733668,0.030362471650994285,408,10,398
2,220_692,0.5626990108337259,0.035971242934204825,2173,50,2123
2,221_693,0.6891132729509113,0.10306688865660345,3056,75,2981
2,223_695,0.6003370098039216,0.026519211467724603,416,8,408
2,224_696,0.6316950543812848,0.064352864579104,465,22,443
2,225_697,0.8041455160744501,0.08100661843927967,397,3,394
2,227_699,0.5096510764662212,0.04216381078335538,455,6,449
2,228_700,0.4448441247002398,0.09905308652776065,151,12,139
2,229_701,0.5720842943065166,0.1920384386720933,645,78,567
2,23_34,,,13,0,13
2,230_702,0.5573529411764706,0.03513710511465166,384,10,374
2,231_703,0.5870191150685874,0.13332143924215048,1779,68,1711
2,232_704,0.6618401759530792,0.3175486200119309,383,31,352
2,232_705,0.33962264150943394,0.031525954505141174,383,12,371
2,233_706,0.5205213346597478,0.014868473739261338,2887,26,2861
2,234_707,0.5215818622360678,0.0389248512305028,3077,107,2970
2,235_708,0.6552829989844993,0.12845549768504147,2041,108,1933
2,236_709,0.6685835351089588,0.2719627702856088,465,52,413
2,237_710,0.6700665188470065,0.07693566562914078,466,15,451
2,237_711,0.6975308641975309,0.02,163,1,162
2,238_712,0.5414571428571429,0.03449205756545221,2705,80,2625
2,239_713,0.5300114340735391,0.01252319772967896,2894,29,2865
2,24_35,0.9545454545454545,0.8333333333333333,13,2,11
2,240_714,0.6262999110221332,0.07096716302150238,2703,111,2592
2,241_715,0.49984398197417007,0.04772653650590905,2927,108,2819
2,242_716,0.46535035023689164,0.02906208512334646,2939,93,2846
2,243_717,0.4607689003436426,0.012048870695314002,2950,40,2910
2,244_718,0.4020112502653364,0.007380020936894787,2706,14,2692
2,245_719,0.5504493464052288,0.16403660701737588,376,36,340
2,246_720,0.6193416049629777,0.015196755538807677,2649,19,2630
2,247_721,0.5248922835879357,0.02105948723633845,2593,40,2553
2,248_722,0.5246510626543611,0.04368753058421596,2610,98,2512
2,249_724,0.5282326185834957,0.050720332762247834,2691,126,2565
2,25_36,0.13636363636363635,0.13247863247863248,13,2,11
2,250_725,0.9738938053097346,0.08388157894736842,567,2,565
2,250_726,0.8306451612903226,0.09453778748625943,567,9,558
2,251_727,0.6374136607828089,0.017838059594025915,2621,15,2606
2,253_729,0.7268694550063372,0.02637539594061333,266,3,263
2,254_730,0.9203187250996016,0.2402299629529231,255,4,251
2,257_735,0.5126021798365122,0.11192091417601006,411,44,367
2,258_736,0.4941919191919192,0.014800980112199682,401,5,396
2,259_737,0.5049896765313145,0.007138516663444222,1463,10,1453
2,26_37,,,13,0,13
2,260_738,0.5863033828654656,0.06991041408793,2452,98,2354
2,261_739,0.5523147228293265,0.14170209209036116,789,70,719
2,262_740,0.666046039268788,0.10836165759433086,429,7,422
2,263_741,0.5511811023622047,0.15696705111305917,414,33,381
2,264_742,0.6034160435078179,0.00798482871930782,2952,10,2942
2,265_743,0.5334138153053716,0.09166511964409897,2596,180,2416
2,266_744,0.6086661941294196,0.03731070009629137,1531,32,1499
2,267_745,0.6923233557320302,0.04926236933405698,1667,30,1637
2,268_746,0.6013736649803261,0.047734071419350634,2456,84,2372
2,269_747,0.5661218401632909,0.04734539476427374,3005,110,2895
2,27_38,0.6849999999999999,0.7740601503759399,20,10,10
2,27_39,0.7760416666666666,0.787750626566416,20,8,12
2,27_40,,,16,0,16
2,270_748,0.5618080565559557,0.010295556168464035,2877,21,2856
2,271_749,0.4843621680810293,0.16257225221025914,333,52,281
2,272_750,0.4754918588873813,0.05220311901641822,547,11,536
2,273_751,0.5138888888888888,0.05085135144861555,373,13,360
2,274_752,0.4035567606996179,0.0057437595391684705,3024,21,3003
2,275_753,0.8601532567049808,0.5633333333333334,267,6,261
2,275_754,0.5759133126934983,0.052618455347304374,2994,19,2975
2,276_755,0.39972089314194575,0.010922236851931257,2542,34,2508
2,277_756,0.6274967109197465,0.025773552758883232,2793,6,2787
2,278_757,0.49769546494415284,0.02986093819092841,2549,72,2477
2,279_758,0.3787024622135544,0.004720200347548359,2358,14,2344
2,280_759,0.5798151815181518,0.009022277674229865,2540,15,2525
2,281_760,0.4840206185567011,0.015783936622071452,393,5,388
2,283_762,0.4517880794701986,0.08796882404747842,327,25,302
2,29_43,,,15,0,15
2,3_3,0.9166666666666666,0.5,13,1,12
2,37_69,,,10,0,10
2,37_70,0.5,0.26666666666666666,10,2,8
2,37_74,,,10,0,10
2,37_77,,,10,0,10
2,40_95,0.7777777777777778,0.3333333333333333,10,1,9
2,40_96,0.7777777777777778,0.3333333333333333,10,1,9
2,42_103,,,11,0,11
2,42_104,,,11,0,11
2,44_106,0.4,0.14285714285714285,11,1,10
2,46_120,1.0,1.0,11,1,10
2,49_149,,,13,0,13
2,5_5,,,19,0,19
2,50_154,,,7,0,7
2,53_178,0.0,0.09090909090909091,11,1,10
2,54_179,0.2222222222222222,0.125,10,1,9
2,54_182,0.5833333333333334,0.3666666666666667,8,2,6
2,6_7,,,7,0,7
2,7_10,,,10,0,10
2,7_11,,,10,0,10
2,70_211,1.0,1.0,18,1,17
2,71_212,0.25,0.1111111111111111,11,1,10
2,71_213,0.25,0.1111111111111111,11,1,10
2,76_230,,,15,0,15
2,78_237,,,11,0,11
2,8_12,,,10,0,10
2,8_13,,,10,0,10
2,80_239,0.0,0.08333333333333333,12,1,11
2,81_241,,,23,0,23
2,82_242,0.75,0.34090909090909094,22,2,20
2,82_243,1.0,1.0,8,1,7
2,83_244,0.9545454545454546,0.5,23,1,22
2,83_245,,,11,0,11
2,84_246,,,11,0,11
2,85_247,0.5833333333333334,0.6602564102564102,13,4,9
2,85_248,0.8333333333333334,0.45,14,2,12
2,86_249,0.22222222222222227,0.17142857142857143,11,2,9
2,86_250,0.0,0.14090909090909093,11,2,9
2,88_252,,,30,0,30
2,88_254,0.8222222222222222,0.5873015873015872,18,3,15
2,89_255,0.0,0.0625,16,1,15
2,9_14,,,4,0,4
2,9_17,,,10,0,10
2,9_18,1.0,1.0,4,1,3
2,90_256,0.7027027027027027,0.08333333333333333,38,1,37
2,91_257,,,10,0,10
2,92_258,0.4375,0.2777777777777778,10,2,8
2,93_259,0.8131313131313131,0.749743829155594,31,9,22
3,1_1,,,12,0,12
3,10_19,,,7,0,7
3,10_20,,,9,0,9
3,100_277,0.6666666666666666,0.7222222222222222,7,3,4
3,100_278,0.8333333333333334,0.9166666666666666,7,4,3
3,104_291,0.7,0.5,7,2,5
3,105_355,0.8333333333333334,0.5,7,1,6
3,105_369,0.5,0.25,7,1,6
3,105_361,,,7,0,7
3,105_378,0.7,0.5,7,2,5
3,105_352,0.7,0.5,7,2,5
3,104_289,0.7,0.5,7,2,5
3,105_377,,,7,0,7
3,105_375,0.5,0.25,7,1,6
3,104_325,0.6666666666666667,0.5,4,1,3
3,104_297,0.6666666666666667,0.5,4,1,3
3,104_295,,,4,0,4
3,104_299,1.0,1.0,4,2,2
3,104_300,0.5,0.5,3,1,2
3,104_326,,,3,0,3
3,104_319,,,4,0,4
3,104_323,1.0,1.0,4,2,2
3,104_334,,,4,0,4
3,105_339,0.7,0.5,7,2,5
3,105_341,0.7,0.5,7,2,5
3,105_360,0.7,0.5,7,2,5
3,105_362,0.7,0.5,7,2,5
3,105_374,0.7,0.5,7,2,5
3,105_382,0.7,0.5,7,2,5
3,105_385,,,4,0,4
3,105_391,,,4,0,4
3,106_392,,,9,0,9
3,108_394,0.8,0.5,6,1,5
3,109_395,0.4,0.25,6,1,5
3,11_21,,,4,0,4
3,11_22,0.33333333333333337,0.3333333333333333,4,1,3
3,110_396,,,4,0,4
3,110_397,,,23,0,23
3,110_398,,,24,0,24
3,110_399,0.7717391304347826,0.5769230769230769,25,2,23
3,110_400,,,24,0,24
3,110_401,0.5166666666666666,0.16566113624937157,23,3,20
3,111_402,0.44166666666666665,0.4805555555555555,16,6,10
3,112_406,0.0,0.3333333333333333,3,1,2
3,113_407,,,3,0,3
3,114_408,0.5,0.5,3,1,2
3,115_409,0.8333333333333334,0.5,7,1,6
3,116_411,0.5,0.1,19,1,18
3,116_412,0.5625,0.1736111111111111,18,2,16
3,116_413,,,8,0,8
3,116_414,,,8,0,8
3,116_415,,,6,0,6
3,116_416,,,5,0,5
3,116_420,,,8,0,8
3,116_421,,,8,0,8
3,116_424,,,8,0,8
3,116_425,,,9,0,9
3,116_426,0.5294117647058824,0.1111111111111111,18,1,17
3,116_427,0.4895833333333333,0.17976190476190476,19,3,16
3,117_429,0.7142857142857143,0.3333333333333333,8,1,7
3,117_430,0.6666666666666667,0.3333333333333333,7,1,6
3,118_432,0.711111111111111,0.7291666666666666,18,3,15
3,118_434,0.6666666666666666,0.9166666666666665,4,3,1
3,12_23,0.5,0.5317460317460317,7,3,4
3,13_24,0.5,0.5317460317460317,7,3,4
3,133_474,0.75,0.5,5,1,4
3,134_476,,,1,0,1
3,134_477,0.75,0.5,5,1,4
3,135_479,,,1,0,1
3,14_25,0.5,0.5317460317460317,7,3,4
3,143_495,0.33333333333333337,0.14285714285714285,10,1,9
3,145_497,,,5,0,5
3,15_26,1.0,1.0,7,3,4
3,153_510,,,4,0,4
3,154_511,,,5,0,5
3,16_27,0.75,0.8928571428571428,7,4,3
3,160_519,0.4285714285714286,0.058823529411764705,29,1,28
3,167_539,,,3,0,3
3,167_538,,,3,0,3
3,168_541,,,13,0,13
3,168_542,,,6,0,6
3,168_543,,,6,0,6
3,169_544,0.6666666666666667,0.25,10,1,9
3,169_545,0.8888888888888888,0.5,10,1,9
3,169_548,,,10,0,10
3,169_549,0.76,0.8083333333333333,10,5,5
3,17_28,,,5,0,5
3,170_550,,,4,0,4
3,170_551,,,4,0,4
3,174_555,0.625,0.25,9,1,8
3,175_559,,,3,0,3
3,175_561,,,3,0,3
3,177_585,0.5915798611111112,0.047521924962863116,440,8,432
3,178_591,0.8888888888888888,0.5,10,1,9
3,178_684,0.5972222222222222,0.2004010096995103,243,15,228
3,179_659,0.5261020881670534,0.0181956940874036,433,2,431
3,18_29,,,7,0,7
3,180_686,0.6238532110091743,0.18345287917867603,122,13,109
3,181_599,0.25,0.25,5,1,4
3,181_600,,,5,0,5
3,183_604,0.6077844311377245,0.28961931829382837,183,16,167
3,184_606,0.6675685425685425,0.36220705166406536,243,12,231
3,185_665,0.5946428571428571,0.06948472830844006,292,12,280
3,185_666,0.6238502673796791,0.12100323119896837,292,17,275
3,185_667,,,292,0,292
3,186_668,0.24331983805668014,0.014654695053320212,252,5,247
3,186_669,,,252,0,252
3,187_618,0.2862776025236593,0.006393262093156049,319,2,317
3,187_619,0.9090909090909091,0.3333333333333333,23,1,22
3,19_30,1.0,1.0,5,3,2
3,190_628,0.45494579945799457,0.023513188978767707,377,8,369
3,190_629,0.5807200929152148,0.048348842427298096,376,7,369
3,190_674,0.4647945205479452,0.033044652822401134,375,10,365
3,191_630,0.5985086342229199,0.012663287039073566,643,6,637
3,191_631,0.6232449297971918,0.006142322097378278,643,2,641
3,191_675,0.6333333333333333,0.04627496159754224,302,2,300
3,192_635,0.8888888888888888,0.5,10,1,9
3,193_723,0.5840336134453782,0.07307017946447245,250,12,238
3,194_639,0.46561302681992334,0.0684794814363052,363,15,348
3,194_678,0.6284722222222222,0.017768832662449684,362,2,360
3,195_642,0.6098196138211383,0.1998072598671815,352,24,328
3,196_644,0.5747773089545241,0.006177921262667026,714,3,711
3,197_645,0.45626884963377856,0.09182504990947123,233,22,211
3,197_646,0.4257269279393173,0.03045573658108411,233,7,226
3,197_647,0.1333333333333333,0.07142857142857142,16,1,15
3,197_648,,,16,0,16
3,197_649,0.5298826261872175,0.1179474062077612,560,47,513
3,197_650,0.5905594688689175,0.10346419197784555,560,23,537
3,197_651,0.6818794964028777,0.07974936532949042,560,4,556
3,198_682,0.6016068052930057,0.19683364492436972,345,23,322
3,199_657,0.5875889817393996,0.11339334210572864,368,9,359
3,200_658,,,3,0,3
3,201_660,0.8201754385964912,0.5416666666666666,59,2,57
3,202_661,0.8510610766045549,0.19039814406223426,491,8,483
3,203_662,,,363,0,363
3,204_663,0.4218898385565052,0.0569126794966964,357,6,351
3,205_664,0.567034203420342,0.115153370987722,549,44,505
3,206_670,0.5653409090909091,0.27571341675356276,356,4,352
3,206_671,0.4809523809523809,0.021322253673623608,356,6,350
3,207_672,0.5242868999257415,0.07640497581298858,626,39,587
3,208_673,0.8739612188365651,0.095313382269904,366,5,361
3,209_676,0.7380546075085324,0.006369426751592357,587,1,586
3,21_32,,,7,0,7
3,210_677,0.495596020445418,0.02452340057062459,937,24,913
3,212_680,0.7466487935656836,0.015268065268065269,375,2,373
3,213_681,0.5521523178807948,0.12696466645460577,338,36,302
3,214_683,0.35546218487394965,0.013099395100027016,362,5,357
3,215_685,0.8979118329466358,0.46619678876451864,448,17,431
3,216_687,0.32043010752688167,0.011730590572761703,377,5,372
3,217_688,0.6175557179393497,0.1958276769414894,356,34,322
3,217_689,0.48703483768804434,0.03208899330622365,433,12,421
3,219_691,0.5041666666666667,0.022311764641335045,366,6,360
3,220_692,0.5269081286694782,0.03562918140188909,2143,58,2085
3,221_693,0.6602493724688058,0.09748118798458921,3080,73,3007
3,223_695,0.5508021390374331,0.06182628671870849,382,8,374
3,224_696,0.5390456506110711,0.06490565362363868,454,26,428
3,225_697,0.938134810710988,0.18229166666666666,364,3,361
3,227_699,0.5670403587443945,0.10192761885858498,451,5,446
3,228_700,0.5862179487179486,0.0618460836940051,203,8,195
3,229_701,0.5366305455219043,0.12270393480591094,791,59,732
3,23_34,0.5,0.25,7,1,6
3,230_702,0.44833096590909094,0.08066815971055313,360,8,352
3,231_703,0.5237088705699993,0.12261809902568971,1631,54,1577
3,232_704,0.6961005478569127,0.30822583005905796,350,29,321
3,232_705,0.6891891891891893,0.20340221595470903,350,17,333
3,233_706,0.607331927851956,0.03094586447578218,2876,30,2846
3,234_707,0.5688019917405995,0.06791130190805589,3096,119,2977
3,235_708,0.5988345151626181,0.0647224765319794,2244,86,2158
3,236_709,0.6805695989214696,0.24355697317009972,457,43,414
3,237_710,0.5807728856509344,0.03077577927290057,458,7,451
3,237_711,0.002824858757062121,0.0056179775280898875,178,1,177
3,238_712,0.5825186889016677,0.08549737135915261,2639,148,2491
3,239_713,0.5128108393168634,0.0170920091279797,2784,45,2739
3,24_35,0.8,0.5833333333333333,7,2,5
3,240_714,0.6162896145481394,0.06370635493073021,2641,98,2543
3,241_715,0.4998861754586945,0.03252981851345085,2850,99,2751
3,242_716,0.5197018352906032,0.018672773086045463,2857,38,2819
3,243_717,0.4573732000748021,0.010995277932300339,2865,34,2831
3,244_718,0.5093526801192705,0.01538017253413135,2644,22,2622
3,245_719,0.6309692157076037,0.17768440430178203,346,29,317
3,246_720,0.6395050685748358,0.016515057597534633,2606,26,2580
3,247_721,0.634828619929931,0.018965922548533076,2550,33,2517
3,248_722,0.48322493380914,0.025561605859476654,2552,70,2482
3,249_724,0.5102708916433427,0.05011031876457288,2621,120,2501
3,25_36,0.7,0.5,7,2,5
3,250_725,0.8794746629474663,0.10048767950038157,723,6,717
3,250_726,0.879817892503536,0.15440907489596264,723,16,707
3,251_727,0.798233004943379,0.13922891814606067,2615,22,2593
3,253_729,0.5542199488491049,0.10063219549899874,411,20,391
3,254_730,0.9897435897435898,0.14285714285714285,586,1,585
3,257_735,0.49880581891872333,0.11460275659486563,378,41,337
3,258_736,0.7778532608695653,0.02337540906965872,370,2,368
3,259_737,0.4725194552529183,0.007938852191851172,1293,8,1285
3,26_37,,,7,0,7
3,260_738,0.5727889910657057,0.10072152980461323,2416,134,2282
3,261_739,0.6415427369686045,0.09494242422299011,993,42,951
3,262_740,0.652485994397759,0.06066158302277279,415,7,408
3,263_741,0.5644203910614526,0.1914575591867398,382,24,358
3,264_742,0.679022687609075,0.012126194635028684,2870,5,2865
3,265_743,0.5760004798104749,0.08784983823760625,2714,129,2585
3,266_744,0.4644658291009534,0.033480724473907306,1348,43,1305
3,267_745,0.6546235339822136,0.07044081747823693,1850,53,1797
3,268_746,0.5806045340050379,0.04082301678742453,2450,68,2382
3,269_747,0.545043388357985,0.08125004961005015,3002,173,2829
3,27_38,0.5,0.6067821067821068,12,6,6
3,27_39,0.40625,0.32067099567099566,12,4,8
3,27_40,,,7,0,7
3,270_748,0.565181762003278,0.0180979127976642,2876,13,2863
3,271_749,0.4897047397047397,0.18194029252361638,349,52,297
3,272_750,0.49462623220153346,0.03295791108173741,686,22,664
3,273_751,0.5641666666666667,0.02303632882507071,406,6,400
3,274_752,0.5482046237088046,0.011305171000471938,3015,19,2996
3,275_753,0.9329710144927537,0.31560846560846556,282,6,276
3,275_754,0.5382924288384349,0.011079069343088548,2989,22,2967
3,276_755,0.6059194711538461,0.030057428120567525,2532,36,2496
3,277_756,0.7838033261026753,0.021970542141472094,2769,3,2766
3,278_757,0.5182847896440129,0.045119894488109005,2547,75,2472
3,279_758,0.6027746875204502,0.02533930140432298,2197,14,2183
3,280_759,0.6364470923261392,0.02143556257329105,2534,32,2502
3,281_760,0.5093052109181141,0.017365456821026283,405,2,403
3,283_762,0.5517021276595745,0.1994884308388619,307,25,282
3,29_43,,,4,0,4
3,3_3,,,3,0,3
3,37_69,1.0,1.0,4,1,3
3,37_70,,,4,0,4
3,37_74,,,4,0,4
3,37_77,,,4,0,4
3,40_95,,,4,0,4
3,40_96,,,4,0,4
3,42_103,1.0,1.0,3,1,2
3,42_104,0.5,0.8333333333333333,3,2,1
3,44_106,,,3,0,3
3,46_120,0.5,0.5,3,1,2
3,49_149,0.0,0.25,4,1,3
3,5_5,0.6666666666666667,0.3333333333333333,7,1,6
3,50_154,,,1,0,1
3,53_178,,,3,0,3
3,54_179,,,3,0,3
3,54_182,,,1,0,1
3,6_7,,,6,0,6
3,7_10,,,4,0,4
3,7_11,,,4,0,4
3,70_211,,,8,0,8
3,71_212,0.0,0.3333333333333333,3,1,2
3,71_213,0.5,0.8333333333333333,3,2,1
3,76_230,,,4,0,4
3,78_237,0.5,0.5,3,1,2
3,8_12,0.33333333333333337,0.3333333333333333,4,1,3
3,8_13,,,4,0,4
3,80_239,,,4,0,4
3,81_241,,,8,0,8
3,82_242,,,8,0,8
3,82_243,0.0,0.5,2,1,1
3,83_244,,,8,0,8
3,83_245,,,3,0,3
3,84_246,,,3,0,3
3,85_247,0.5,0.75,4,2,2
3,85_248,1.0,1.0,4,1,3
3,86_249,0.5,0.5,3,1,2
3,86_250,,,3,0,3
3,88_252,,,11,0,11
3,88_254,,,5,0,5
3,89_255,,,5,0,5
3,9_14,0.5,0.5,3,1,2
3,9_17,,,4,0,4
3,9_18,0.5,0.5,3,1,2
3,90_256,,,23,0,23
3,91_257,0.6666666666666666,0.9166666666666665,4,3,1
3,92_258,0.6666666666666666,0.9166666666666665,4,3,1
3,93_259,0.375,0.3663964598997494,19,8,11
4,1_1,,,25,0,25
4,10_19,0.761904761904762,0.16666666666666666,22,1,21
4,10_20,0.32692307692307687,0.14285714285714285,15,2,13
4,100_277,0.9166666666666666,0.8666666666666667,11,3,8
4,100_278,0.9642857142857143,0.95,11,4,7
4,104_291,1.0,1.0,9,3,6
4,105_355,0.7142857142857143,0.41666666666666663,9,2,7
4,105_369,0.625,0.25,9,1,8
4,105_361,0.7142857142857143,0.41666666666666663,9,2,7
4,105_378,0.7857142857142857,0.5,9,2,7
4,105_352,0.8333333333333334,0.6388888888888888,9,3,6
4,104_289,1.0,1.0,9,4,5
4,105_377,0.625,0.25,9,1,8
4,105_375,0.7142857142857143,0.41666666666666663,9,2,7
4,104_325,1.0,1.0,8,3,5
4,104_297,0.8333333333333334,0.5833333333333333,8,2,6
4,104_295,0.8571428571428572,0.5,8,1,7
4,104_299,1.0,1.0,8,3,5
4,104_300,1.0,1.0,2,1,1
4,104_326,,,2,0,2
4,104_319,0.8571428571428572,0.5,8,1,7
4,104_323,1.0,1.0,8,3,5
4,104_334,0.8571428571428572,0.5,8,1,7
4,105_339,0.9500000000000001,0.95,9,4,5
4,105_341,1.0,1.0,9,4,5
4,105_360,0.8333333333333334,0.6388888888888888,9,3,6
4,105_362,0.7857142857142857,0.5,9,2,7
4,105_374,0.8333333333333334,0.6388888888888888,9,3,6
4,105_382,0.8333333333333334,0.6388888888888888,9,3,6
4,105_385,0.8571428571428572,0.5,8,1,7
4,105_391,0.8571428571428572,0.5,8,1,7
4,106_392,0.32692307692307687,0.14285714285714285,15,2,13
4,108_394,,,4,0,4
4,109_395,,,4,0,4
4,11_21,,,5,0,5
4,11_22,0.75,0.5,5,1,4
4,110_396,1.0,1.0,5,1,4
4,110_397,0.6428571428571428,0.265,32,4,28
4,110_398,0.5277777777777778,0.1181077694235589,33,3,30
4,110_399,0.6206896551724137,0.1477124183006536,32,3,29
4,110_400,0.6428571428571428,0.13392857142857142,30,2,28
4,110_401,0.7589285714285714,0.31805555555555554,32,4,28
4,111_402,1.0,1.0,19,1,18
4,112_406,1.0,1.0,5,1,4
4,113_407,1.0,1.0,5,1,4
4,114_408,,,5,0,5
4,115_409,,,10,0,10
4,116_411,0.35500000000000004,0.1930718954248366,25,5,20
4,116_412,0.3977272727272727,0.09821428571428571,24,2,22
4,116_413,0.5,0.6,10,2,8
4,116_414,,,10,0,10
4,116_415,1.0,1.0,4,1,3
4,116_416,,,11,0,11
4,116_420,0.32352941176470584,0.07692307692307693,18,1,17
4,116_421,0.3111111111111111,0.15925925925925927,18,3,15
4,116_424,0.75,0.2,17,1,16
4,116_425,0.1842105263157895,0.058823529411764705,20,1,19
4,116_426,0.14285714285714285,0.0944616977225673,24,3,21
4,116_427,0.4692982456140351,0.2492889681124975,25,6,19
4,117_429,0.9866666666666667,0.9666666666666666,20,5,15
4,117_430,0.736842105263158,0.16666666666666666,20,1,19
4,118_432,0.75,0.29166666666666663,16,2,14
4,118_434,0.5,0.325,8,2,6
4,12_23,1.0,1.0,14,5,9
4,13_24,1.0,1.0,14,5,9
4,133_474,,,8,0,8
4,134_476,,,7,0,7
4,134_477,,,8,0,8
4,135_479,0.6666666666666667,0.3333333333333333,7,1,6
4,14_25,1.0,1.0,14,5,9
4,143_495,0.5142857142857143,0.3058333333333333,19,5,14
4,145_497,0.75,0.5833333333333333,6,2,4
4,15_26,1.0,1.0,14,2,12
4,153_510,0.8,0.3333333333333333,11,1,10
4,154_511,0.7777777777777778,0.41666666666666663,11,2,9
4,16_27,0.9393939393939393,0.8666666666666667,14,3,11
4,160_519,,,31,0,31
4,167_539,0.75,0.6666666666666666,10,2,8
4,167_538,0.75,0.6666666666666666,10,2,8
4,168_541,,,21,0,21
4,168_542,0.5897435897435898,0.2619047619047619,16,3,13
4,168_543,0.7179487179487178,0.5396825396825397,16,3,13
4,169_544,0.6794871794871794,0.33535353535353535,16,3,13
4,169_545,0.6071428571428571,0.25757575757575757,16,2,14
4,169_548,0.625,0.2111111111111111,16,2,14
4,169_549,0.8571428571428572,0.9057470307470308,16,9,7
4,17_28,,,10,0,10
4,170_550,0.7,0.25,11,1,10
4,170_551,,,11,0,11
4,174_555,,,23,0,23
4,175_559,,,5,0,5
4,175_561,,,5,0,5
4,177_585,,,305,0,305
4,178_591,0.6666666666666667,0.16666666666666666,16,1,15
4,178_684,0.8622334455667788,0.5596270980481507,173,11,162
4,179_659,0.7800687285223368,0.015151515151515152,292,1,291
4,18_29,1.0,1.0,14,5,9
4,180_686,0.6823529411764706,0.2188691148172513,96,11,85
4,181_599,,,7,0,7
4,181_600,,,7,0,7
4,183_604,0.6513994910941475,0.3402469135802469,140,9,131
4,184_606,0.8432692307692308,0.6310839237851265,173,13,160
4,185_665,0.4320312500000001,0.02751217042913551,164,4,160
4,185_666,0.6017932489451476,0.06866216600684161,164,6,158
4,185_667,,,164,0,164
4,186_668,0.9478653530377668,0.644743351886209,181,7,174
4,186_669,0.9259776536312848,0.16203703703703703,181,2,179
4,187_618,0.7395833333333333,0.25,227,3,224
4,187_619,0.9166666666666666,0.45,26,2,24
4,19_30,1.0,1.0,10,2,8
4,190_628,0.8052235502434706,0.434560997905042,260,9,251
4,190_629,0.49215686274509807,0.04590394966672072,260,5,255
4,190_674,0.381,0.015224291610345195,254,4,250
4,191_630,0.3417508417508417,0.014220421600160509,504,9,495
4,191_631,0.3634072580645161,0.01317720147695883,504,8,496
4,191_675,,,171,0,171
4,192_635,1.0,1.0,16,1,15
4,193_723,0.3853503184713376,0.01950246831712349,160,3,157
4,194_639,0.5514409221902018,0.044405647907596935,357,10,347
4,194_678,0.710960960960961,0.04534305527683011,225,3,222
4,195_642,0.5516875602700096,0.23691843755240258,339,34,305
4,196_644,0.6638127853881278,0.011507659063001687,587,3,584
4,197_645,0.5941358024691358,0.16102035790610375,123,15,108
4,197_646,0.6932203389830508,0.07440450605344222,123,5,118
4,197_647,0.6442307692307692,0.32767857142857143,17,4,13
4,197_648,0.65,0.225,17,2,15
4,197_649,0.5908339759832544,0.1358885069980605,342,29,313
4,197_650,0.7949101796407185,0.1559795618205524,342,8,334
4,197_651,0.7841691248770895,0.08124253285543608,342,3,339
4,198_682,0.7841517857142857,0.24815393081838444,341,21,320
4,199_657,0.552832674571805,0.12665905740609315,356,11,345
4,200_658,,,5,0,5
4,201_660,0.9481707317073171,0.5416666666666666,45,4,41
4,202_661,0.9542613636363635,0.6134055351111368,452,12,440
4,203_662,,,354,0,354
4,204_663,0.586437440305635,0.015384156564469731,352,3,349
4,205_664,0.5183738425925926,0.1448756005395108,472,40,432
4,206_670,0.5481150793650794,0.0311910165214334,345,9,336
4,206_671,0.5385773864689528,0.07852855864961138,345,13,332
4,207_672,0.6443107546048723,0.07676822220774346,413,17,396
4,208_673,0.517012893982808,0.029954530784102755,357,8,349
4,209_676,0.47454751131221723,0.006182513139034878,444,2,442
4,21_32,0.16666666666666663,0.16666666666666666,7,1,6
4,210_677,0.6265229044834308,0.023550348013353487,696,12,684
4,212_680,0.5280898876404494,0.0058823529411764705,357,1,356
4,213_681,0.4872036920495071,0.09400193085823702,248,21,227
4,214_683,0.5088757396449705,0.03708793070578107,345,7,338
4,215_685,0.7903785488958991,0.28554965824105083,337,20,317
4,216_687,,,364,0,364
4,217_688,0.6429038281979459,0.17145843828206567,349,34,315
4,217_689,0.4953751284686536,0.0623811718253024,292,14,278
4,219_691,0.45784883720930236,0.04178682277322783,351,7,344
4,220_692,0.5741271074712091,0.03242707915892122,2214,53,2161
4,221_693,0.6180114772628468,0.055640350504466154,3061,93,2968
4,223_695,0.5296296296296297,0.018802120854860816,366,6,360
4,224_696,0.6170316301703163,0.04736500571912859,426,15,411
4,225_697,0.11671469740634005,0.0031545741324921135,348,1,347
4,227_699,0.44999999999999996,0.011894626005513767,419,4,415
4,228_700,0.6114503816793894,0.3165267501794219,141,10,131
4,229_701,0.5054313914572579,0.1163161616342683,639,61,578
4,23_34,0.8333333333333334,0.5,7,1,6
4,230_702,0.5906007751937984,0.025905724627938623,350,6,344
4,231_703,0.5839538421505635,0.10349237756098267,1699,61,1638
4,232_704,0.6928030303030303,0.24987706998510534,338,30,308
4,232_705,0.6042768959435626,0.08177228206521861,338,14,324
4,233_706,0.5764404383174266,0.028839590107921028,2879,50,2829
4,234_707,0.5733233556111785,0.043603885757473655,3072,91,2981
4,235_708,0.6553907308802431,0.08276224544854172,2114,87,2027
4,236_709,0.7202778519903821,0.35391318667207367,432,38,394
4,237_710,0.6279481132075472,0.03985469781423866,432,8,424
4,237_711,,,145,0,145
4,238_712,0.6352706991418001,0.08229895042842997,2688,103,2585
4,239_713,0.5885467909022513,0.0172968684738944,2839,37,2802
4,24_35,,,7,0,7
4,240_714,0.6709462038907535,0.059725666552691806,2664,98,2566
4,241_715,0.5027854788931317,0.047039469945929606,2871,140,2731
4,242_716,0.517078265960561,0.02179752610353786,2889,53,2836
4,243_717,0.530190561320327,0.013312161667598126,2886,27,2859
4,244_718,0.5213996529786004,0.007989295179637895,2658,19,2639
4,245_719,0.4907580477673935,0.04465386056482523,336,15,321
4,246_720,0.6310073683052898,0.008036424598428373,2612,14,2598
4,247_721,0.5706060606060607,0.0178129757414726,2599,25,2574
4,248_722,0.5895666123794384,0.049264337839287534,2583,82,2501
4,249_724,0.5394352036667406,0.05692125910594971,2640,135,2505
4,25_36,0.5,0.41666666666666663,7,2,5
4,250_725,0.7563965884861407,0.09271353086847181,543,7,536
4,250_726,0.8136022514071295,0.22843157845960632,543,10,533
4,251_727,0.6492877528076006,0.03349737813561758,2642,31,2611
4,253_729,0.5853355426677712,0.08805623982674207,301,17,284
4,254_730,0.8779596100278553,0.26033142561135286,367,8,359
4,257_735,0.5767074413863404,0.12828184550004412,363,36,327
4,258_736,0.175561797752809,0.0033783783783783786,357,1,356
4,259_737,0.23906037991858886,0.0036615610397297284,1482,8,1474
4,26_37,0.16666666666666663,0.16666666666666666,7,1,6
4,260_738,0.5427512175546759,0.07923450012286284,2399,146,2253
4,261_739,0.7089044851409145,0.13061008297349555,884,55,829
4,262_740,0.5579691516709512,0.06853315499417577,399,10,389
4,263_741,0.4314235010774497,0.05555665318271864,366,23,343
4,264_742,0.6814847009735744,0.014629998410810937,2886,10,2876
4,265_743,0.5396699617662791,0.08210110851816507,2614,143,2471
4,266_744,0.5296738399462004,0.02716868052864324,1519,32,1487
4,267_745,0.649139344262295,0.08348727497464944,1581,56,1525
4,268_746,0.6088318680506816,0.07473824044692445,2446,92,2354
4,269_747,0.521745137755291,0.05228846876859762,3022,121,2901
4,27_38,0.33333333333333337,0.3831030081030081,14,6,8
4,27_39,0.5833333333333333,0.22619047619047616,14,2,12
4,27_40,,,13,0,13
4,270_748,0.5410021614674612,0.01984770157531479,2877,24,2853
4,271_749,0.5081230413986475,0.16269136027683434,305,47,258
4,272_750,0.7274911032028469,0.04332028823032996,572,10,562
4,273_751,0.6007653061224489,0.03413508142431054,400,8,392
4,274_752,0.46294277579706067,0.015477748530023922,3025,26,2999
4,275_753,0.9061379928315412,0.5889488757304848,257,9,248
4,275_754,0.3771900358891855,0.006010800963084551,2996,19,2977
4,276_755,0.4076017811704834,0.009893471718404729,2513,24,2489
4,277_756,0.9001072577761887,0.02247204117676426,2802,5,2797
4,278_757,0.5200736245512365,0.03585972762446869,2524,67,2457
4,279_758,0.49354085858917895,0.016476528281192553,2187,14,2173
4,280_759,0.7410318419991938,0.02696557342981855,2509,28,2481
4,281_760,0.40467877094972066,0.05069611778457055,366,8,358
4,283_762,0.5330985915492957,0.04011646663802329,294,10,284
4,29_43,,,11,0,11
4,3_3,,,10,0,10
4,37_69,,,8,0,8
4,37_70,,,8,0,8
4,37_74,,,8,0,8
4,37_77,,,8,0,8
4,40_95,0.7500000000000001,0.5,8,2,6
4,40_96,,,8,0,8
4,42_103,,,5,0,5
4,42_104,,,5,0,5
4,44_106,,,5,0,5
4,46_120,1.0,1.0,5,1,4
4,49_149,,,6,0,6
4,5_5,0.7647058823529411,0.2,18,1,17
4,50_154,,,2,0,2
4,53_178,,,5,0,5
4,54_179,,,5,0,5
4,54_182,,,3,0,3
4,6_7,,,9,0,9
4,7_10,,,5,0,5
4,7_11,1.0,1.0,5,2,3
4,70_211,0.10714285714285715,0.07142857142857142,15,1,14
4,71_212,,,5,0,5
4,71_213,,,5,0,5
4,76_230,,,11,0,11
4,78_237,,,6,0,6
4,8_12,0.75,0.5,5,1,4
4,8_13,0.75,0.5,5,1,4
4,80_239,,,6,0,6
4,81_241,0.33333333333333337,0.07692307692307693,19,1,18
4,82_242,0.7058823529411764,0.7222222222222222,20,3,17
4,82_243,0.8571428571428572,0.5,8,1,7
4,83_244,,,19,0,19
4,83_245,0.25,0.25,5,1,4
4,84_246,0.75,0.5,5,1,4
4,85_247,1.0,1.0,11,5,6
4,85_248,,,10,0,10
4,86_249,,,5,0,5
4,86_250,,,5,0,5
4,88_252,,,25,0,25
4,88_254,0.625,0.35,14,2,12
4,89_255,0.7142857142857143,0.45,9,2,7
4,9_14,,,7,0,7
4,9_17,,,6,0,6
4,9_18,0.4,0.325,7,2,5
4,90_256,0.1428571428571429,0.04,29,1,28
4,91_257,1.0,1.0,5,1,4
4,92_258,1.0,1.0,5,1,4
4,93_259,0.5625,0.3176709401709401,26,6,20
